2020年12月8日,比亚迪股份有限公司(以下简称“本公司”)收到中国证券监督管理委员会(以下简称“中国证监会”)出具的《中国证监会行政许可申请受理单》(受理序号:203280)。中国证监会对本公司提交的关于本公司新增发行境外上市外资股(H股)并...	比亚迪股份有限公司investRecordData_logoWord	比亚迪	比亚迪股份有限公司(以下简称本公司) 收到中国证券监督管理委员
格隆汇 7 月 17日丨保变电气(600550.SH)公布，公司于近日收到河北省保定市中级人民法院(“保定中院”)《民事裁定书》((2020)冀06破1-2号)，涉及公司参股公司保定天威英利新能源有限公司(“天威英利”)被裁定实质合并重整。	保定天威英利新能源有限公司logoWord	天威英利	天威英利新能源有限公司(天威英利) 被裁定实质合并重整。
经过充分讨论,以3票同意、0票反对、0票弃权选举蔡伟斌先生为公司第九届监事会监事长。 三、备查文件 第九届监事会第十二次会议决议等。 特此公告。 康佳集团股份有限公司 监 事 会 二〇二一年三月十五日 证券代码:000016、200016 ...	康佳集团股份有限公司directorsData_title	监事	监事长。, 三, 备查文件, 第九届监事会第十二次会议决议等。, 特此公
你公司第五届董事会第三次会议审议通过了你公司为全资子公司南京奥特佳新能源科技有限公司申请银行综合授信额度及银行贷款提供8亿元担保额度的议案。本公司及本公司的一致行动人提名的你公司董事均投票赞成。为进一步强化公司治理,完善对你公...	南京奥特佳新能源科技有限公司holdsData_logoWord	奥特佳	奥特佳新能源科技有限公司申请银行综合授信额度及银行贷款提供8亿元
张勇爱士惟新能源技术(江苏)有限公司总裁 陈国光华为技术有限公司智能光伏事业部总裁 杨立友晋能清洁能源科技股份公司总经理 12:00 - 13:30 自助午餐 主持嘉宾:吕芳 中科院电工所高级工程师,中国绿色供应链联盟光伏专委会秘书长,2020第五...	爱士惟新能源技术(江苏)有限公司legalPerson	张勇	张勇爱士惟新能源技术(江苏) 有限公司总裁, 陈国光华为技术有限公司
2021年4月26日,东风汽车集团发布消息:受中组部委托,东风公司董事长、党委书记竺延风同志宣布了中组部关于干部任职的决定:黄伟任东风汽车集团有限公司董事、党委副书记。 黄伟同志简历 打开腾讯新闻,查看更多图片 > 黄伟,男,1965年7月出生...	东风汽车集团有限公司directorsData_title	董事	董事长, 党委书记😎
甲方:中国广核集团有限公司 乙方:中国广核电力股份有限公司 (二)服务范围 中广核下属金融服务提供方向本集团提供金融服务,主要包括但不限于吸收存款、发放贷款、委托贷款、综合常年财务顾问服务、专项财务顾问服务、结算服务、保险服务、融资租...	中国广核集团有限公司investRecordData_logoWord	广核电力	中广核下属金融服务提供方向本集团提供金融服务, 主要包括但不限于吸
挖贝网讯 7月7日消息,司青岛科创蓝新能源股份有限公司青岛科创蓝新能源股份有限公司(证券简称:科创蓝 证券代码:835968)今天正式在新三板公开发行股票241.67万股(其中有限售条件93.33万股,无限售条件148.33万股),募集资金7250万元。股...	青岛科创蓝新能源股份有限公司logoWord	科创蓝	科创蓝新能源股份有限公司青岛科创蓝新能源股份有限公司(证券简称:
10月29日，上海电力（600021.SH）公告称，拟投资1.58亿元获得上海舜华新能源系统有限公司（下称上海舜华）27.8%的股权。同时，关联公司国家电投集团综合智慧能源科技有限公司也将投资0.34亿元，获得上海舜华另外6%的股权。上海电力的...	上海舜华新能源系统有限公司shareholdersData_logoWord	国家电投	投资1.58亿元获得上海舜华新能源系统有限公司（下称上海舜华）27.
【沧能股份拟出资1800万元设参股公司】沧能股份(871867)10月12日公告,公司拟与国网河北省电力有限公司、沧州临港兴化售电有限公司共同出资设立参股公司沧州源兴配售电有限责任公司,注册地为河北省沧州临港经济技术开发区,注册资本为2亿元,...	国网河北省电力有限公司logoWord	国网河	国网河北省电力有限公司, 沧州临港兴化售电有限公司共同出资设立参股
3月30日，国网上海市电力公司科技部主任华斌、科技部副主任黄兴德、电科院副院长朱征一行到上海电力大学进行科技调研。上海电力大学副校长符杨出席会议。科研处、电气工程学院、计算机科学与技术学院、电子与信息工程学院、自动化工程学院...	国网上海市电力公司holdsData_logoWord	国网上海	国网上海市电力公司科技部主任华斌, 科技部副主任黄兴德, 电科院副院
光合联萌 指 光漾联萌互联网金融信息服务(上海)有限公司,系公司全资公司 公司章程 指 东方日升新能源股份有限公司章程 2016 年度定增事项 指 2016 年度非公开发行股票事项 股权激励计划 指 东方日升首期限制性股票激励计划 ...	东方日升新能源股份有限公司holdsData_entName	光漾联萌互联网金融信息服务(上海)有限公司	东方日升新能源股份有限公司章程, 2016, 年度定增事项, 指, 2016, 年度非
同正公司)与家天下资产 管理有限公司(以下简称家天下公司),刘悉承签订了《关于重庆万里新能源股份有限公司之股份转让...√适用□不适用 本公司将重庆万里华丰电池销售有限责任公司和北京华宇易丰科技发展有限公司 2 家子公司纳入本期合 ...	重庆万里新能源股份有限公司investRecordData_logoWord	万里华丰	万里华丰电池销售有限责任公司和北京华宇易丰科技发展有限公司, 2,
[车友头条-车友号-东风] 4月29日,东风汽车有限公司宣布公司管理层人事调整,以进一步强化东风有限领导团队,推进东风有限事业计划的实施。 日产汽车公司特殊项目企业副总裁山口武(Takeshi Yamaguchi)先生将担任东风汽车有限公司副总裁、东风日产...	东风汽车有限公司shareholdersData_logoWord	汽车	汽车有限公司副总裁, 东风日产. . . 😎
4月2日,爱士惟首次公开亮相第十四届中国(济南)国际太阳能利用暨多能互补应用展览会,爱士惟新能源技术(江苏)有限公司(以下简称爱士惟)产品技术中心总监吴生闻首次面向媒体为爱士惟六年标准质保做了详细的解读。	爱士惟新能源技术(江苏)有限公司logoWord	爱士惟	爱士惟新能源技术(江苏) 有限公司(以下简称爱士惟) 产品技术中心总
深交所公布关于对东旭蓝天新能源股份有限公司及相关当事人给予通报批评处分的决定:对东旭蓝天给予通报批评的处分;对东旭蓝天时任董事长、总经理兼董事会秘书侯继伟,时任董事兼财务总监夏志勇,时任董事李明,董事李泉年、王甫民、黄志良、...	东旭蓝天新能源股份有限公司directorsData_name	黄志良	李泉年, 王甫民, 黄志良, . . . 😎
近日,公司副总经理张利一行赴青岛科创蓝新能源股份有限公司进行洽谈交流。青岛科创蓝新能源股份有限公司董事长迟芳等人出席了会谈。 会谈中,双方就组建魏县清洁能源供热项目SPV公司进行了协商,决定分别成立协调小组,制定联系机制,明确责任分工和...	青岛科创蓝新能源股份有限公司shareholdersData_name	迟芳	迟芳等人出席了会谈。, 会谈中, 双方就组建魏县清洁能源供热项目spv
潍柴动力股份有限公司创建于2002年,总部位于山东潍坊,是中国第一家在香港联交所主版上市的内燃机企业,也是中国最大的汽车零部件企业集团。潍柴动力(潍坊)集约配送有限公司成立于2005年10月,目前担负潍柴集团的主要采购物流、生产物流和销售...	潍柴动力股份有限公司logoWord	潍柴动力	潍柴动力股份有限公司创建于2002年, 总部位于山东潍坊, 是中国第一家在
3、江苏鹏腾建筑有限公司 4、江苏大隆鑫建设集团有限公司 5、浙江佳源物业服务集团有限公司泰兴分公司 6、江苏新能源物业服务有限公司泰兴分公司 7、泰兴百俊房地产开发有限公司 8、江苏新能源置业集团有限公司泰兴分公司 ...	江苏新能源置业集团有限公司holdsData_logoWord	能源物业	能源置业集团有限公司泰兴分公司, . . .
来源：新浪财经 新浪财经讯 7月5日消息，卓越新能公告称，龙岩卓越新能源股份有限公司及下属子公司厦门卓越生物质能源有限公司、福建致尚生物质材料发展有限公司、龙岩卓越生物基材料有限公司自2020年2月29日至2020年7月5日，已累计获得...	龙岩卓越新能源股份有限公司holdsData_entName	厦门卓越生物质能源有限公司	厦门卓越生物质能源有限公司, 福建致尚生物质材料发展有限公司, 龙岩
据知情人士，获腾讯投资的移动互联网医疗健康服务平台微医将于下周与机构投资者进行非交易路演，并寻求最快于季内上市，花旗及招银为联席保荐人。中国长江三峡集团有限公司旗下中国三峡新能源(集团)股份有限公司(以下简称“三峡新能源”)...	中国三峡新能源(集团)股份有限公司shareholdersData_logoWord	长江三峡	中国长江三峡集团有限公司旗下中国三峡新能源(集团) 股份有限公司(
山西省国新能源股份有限公司关于募集资金向全资子公司山西天然气有限公司进行增资并完成工商变更登记的公告,天然气有限公司,山西省国新能源股份有限公司,山西,天然气	山西省国新能源股份有限公司logoWord	国新能源	天然气有限公司, 山西省国新能源股份有限公司, 山西, 天然气
交易内容:公司部分董事和高级管理人员拟持有保定天威英利新能源有限公司(以下简称”天威英利”)的外方股东英利绿色能源控股有限公司(以下简称”开曼公司”)的部分股权,从而间接持有天威英利的股权。	保定天威英利新能源有限公司investRecordData_logoWord	天威英利	天威英利新能源有限公司(以下简称天威英利) 的外方股东英利绿色
东风汽车集团有限公司总经理李绍烛:助推武汉汽车产业转型升级	东风汽车集团有限公司investRecordData_logoWord	汽车	汽车集团有限公司总经理李绍烛: 助推武汉汽车产业转型升级😎
云南电网有限责任公司临沧供电局电网规划与建设部五级职员，原云县供电局党委书记、局长苏荣涉嫌严重违纪违法，经临沧市监委指定沧源佤族自治县监委管辖，目前正接受监察调查。【来源：临沧市纪委】声明：转载此文是出于传递更多信息之目的。若...	云南电网有限责任公司holdsData_logoWord	供电	供电局电网规划与建设部五级职员, 原云县供电局党委书记, 局长😎😎
目前,省引导基金支持的青海华控基金、青海国科创投基金已对青海诺蓝杞生物科技开发有限公司投入1500万元、海北同圣旅游公司投入2000万元,青海绿草地新能源科技有限公司等2家企业通过专利质押获得2550万元贷款;青海省国有科技资产经营管理有限...	青海绿草地新能源科技有限公司logoWord	绿草地	绿草地新能源科技有限公司等2家企业通过专利质押获得2550万元贷款;
表面处理(安平)科技有限公司 融资额度6.3亿元提供担保的公告 一、担保情况概述 根据经营需要,东旭蓝天新能源股份有限公司(以下简称“公司”)全资子公司东旭新能源投资有限公司(以下简称“东旭新能源投资”)持股85%的子公司华融金属表面处理...	东旭蓝天新能源股份有限公司holdsData_logoWord	旭新能源	东旭蓝天新能源股份有限公司(以下简称公司) 全资子公司东旭新能
若后续出现上述风险,胡震先生将采取包括但不限于补充质押、提前还款等措施应对上述风险。上述股份质押事项若出现其他重大变动情况,公司将按照相关规定及时披露。 特此公告。 江苏振江新能源装备股份有限公司董事会...	江苏振江新能源装备股份有限公司investRecordData_logoWord	振江新能	振江新能源装备股份有限公司董事会. . .
江西展宇新能源股份有限公司总裁陈良道、展宇光伏科技(中国)有限公司总经理宋钰、江西展宇新能源股份有限公司总裁助理兼营销中心总监陈平、江西展宇新能源股份有限公司财务总监周小辉、展宇光伏江西事业部总经理涂宏弢、开发经理周彬,与上海上...	江西展宇新能源股份有限公司directorsData_name	宋钰	宋钰, 江西展宇新能源股份有限公司总裁助理兼营销中心总监陈平, 江西
2020年11月3日,中检集团副总裁、中国质量认证中心主任陆梅赴珠海格力电器股份有限公司(以下简称“格力电器”)拜访调研,并与格力电器董事长董明珠女士及相关部门进行了座谈。 会上,陆梅介绍了中检集团的组织架构、业务领域以及国资委对集团的...	珠海格力电器股份有限公司directorsData_name	董明珠	董明珠女士及相关部门进行了座谈。, 会上, 陆梅介绍了中检集团的组织
2021年1月26日,潍柴动力发布公告称,收到山东重工集团有限公司转来的山东省人民政府国有资产监督管理委员会向其出具的 《山东省国资委关于潍柴动力股份有限公司非公开发行A股股票的批复》(鲁国资收益字[2021]3 号),山东省国资委同意潍柴...	潍柴动力股份有限公司shareholdersData_logoWord	国有资产	潍柴动力股份有限公司非公开发行a股股票的批复》(鲁国资收益字[2021
6.5.6 其他综合收益细目  单位:千元  6.6 报告期接待调研、沟通、采访等活动情况表  §7 财务报告  7.1 审计意见  7.2 财务报表  7.2.1 资产负债表  编制单位:比亚迪股份有限公司 2011年06月30日 单位:千元 文档...	比亚迪股份有限公司holdsData_logoWord	比亚迪	比亚迪股份有限公司, 2011年06月30日, 单位: 千元, 文档. . . 😎
原标题:20延长01 : 陕西延长石油(集团)有限责任公司公司债券2020年跟踪评级报告经营带来一定不利影响。2. 公司 债务负担较重,短期债务占比上升。 2019 年,公 司有息债务规模继续增长,若将可 续期债券计入公司债务,公司债务负担较重且...	陕西延长石油(集团)有限责任公司investRecordData_logoWord	石油	石油(集团) 有限责任公司公司债券2020年跟踪评级报告经营带来一定不利
每经编辑:胡玲 据启信宝数据显示,7月17日,中兴通讯股份有限公司发生工商变更,Yuming Bao(鲍毓明)退出公司董事,新增董事为庄坚胜。 工商信息显示,中兴通讯股份有限公司成立于1997年11月	中兴通讯股份有限公司directorsData_title	董事	董事为庄坚胜。, 工商信息显示, 中兴通讯股份有限公司成立于1997年11月
【亿邦动力讯】1月20日消息,有媒体公开报道称,银隆新能源股份有限公司于近日发生人事变动,包括格力电器董事长董明珠在内的6位董事退出,此外,还有监事、监事会主席等退出。对此,银隆新能源相关负责人表示,再三确认,公司董事没有发生任何...	银隆新能源股份有限公司directorsData_title	董事	董事长董明珠在内的6位董事退出, 此外, 还有监事, 监事会主席等退出
英利能源(中国)有限公司、保定天威英利新能源有限公司、蠡县英利新能源有限公司、衡水英利新能源有限公司、天津英利新能源有限公司、海南英利新能源有限公司等六家公司进行实质合并重整,并指定英利能源(中国)有限公司管理人担任实质合并重整管理...	海南英利新能源有限公司holdsData_logoWord	英利能源	英利能源(中国) 有限公司管理人担任实质合并重整管理. . . 😎😎
中电科电子装备集团有限公司(简称“电科装备”)入选“2021全球光伏企业20强(综合类) ”、“2021中国光伏企业20强(综合类)”,旗下湖南红太阳新能源科技有限公司入选“2021中国光伏组件企业20强”。 电科装备总经理助理、湖南红太阳光电科...	湖南红太阳新能源科技有限公司directorsData_title	总经理	总经理助理, 湖南红太阳光电科. . . 😎
针对第一书记的提问,8月15日,山东省太阳能行业协会秘书长彭飞、山东力诺瑞特新能源有限公司科技管理中心总监马保林做客《“‘好品山东’扶贫帮帮团”在行动》专栏为听众介绍农村冬季取暖项目,并会在农村清洁取暖项目上给予“第一书记”...	山东力诺瑞特新能源有限公司holdsData_logoWord	力诺瑞特	力诺瑞特新能源有限公司科技管理中心总监马保林做客《好品山东
8月17日,荣盛盟固利新能源科技有限公司举行300Wh/kg级电动飞机动力电池应用发布会。该款电池可使飞机续航里程达到150分钟。 荣盛盟固利董事长冯全玉表示,从2015年开始,荣盛盟固利陆续开发出了一系列新产品,搭载盟固利电池的RX1E型电动...	荣盛盟固利新能源科技有限公司directorsData_title	董事长	董事长冯全玉表示, 从2015年开始, 荣盛盟固利陆续开发出了一系列新产品
关于监事辞职的公告 郑州宇通客车股份有限公司(以下简称“公司”)监事会于2021年3月17日收到监事张国徽先生的辞职报告书,张国徽先生因工作调整原因申请辞去公司监事职务,辞职报告书自送达监事会之日起…	郑州宇通客车股份有限公司directorsData_title	监事	监事会之日起😎
今日,记者于深圳证券交易所获悉,潍柴动力股份有限公司(潍柴动力.000338.sz)发布2018年度A股分红派息实施公告,潍柴动力向全体股东每10股派发现金2.80元(含税),不实施公积金转增股本。 鲁网7月24日讯(记者 庞洪波)今日,记者于深圳证券交易...	潍柴动力股份有限公司investRecordData_logoWord	潍柴动力	潍柴动力. 000338. sz) 发布2018年度a股分红派息实施公告, 潍柴动力
近日,中国行业报协会组织10多位中央媒体社长、总编辑组成“美丽工厂”媒体采访团,走进珠海格力电器股份有限公司和珠海银隆新能源有限公司,并与格力电器董事长兼总裁董明珠座谈,银隆新能源总裁孙国华陪同参观。参加座谈会的嘉宾一致认为,当前,...	珠海格力电器股份有限公司directorsData_title	董事长	董事长兼总裁董明珠座谈, 银隆新能源总裁孙国华陪同参观。参加座谈会
国家电网两省公司董事长、党委书记调整，一位的前任刚调任南网党组成员、副总经理 【能源人都在看，点击右上角加'关注'】6月，据南方电网官网“公司领导”栏目更新显示，原任国网上海市电力公司董事长、党委书记钱朝阳，调任南方电网...	国网上海市电力公司directorsData_title	董事长	董事长, 党委书记调整, 一位的前任刚调任南网党组成员, 副总经理, 【
【能源人都在看，点击右上角加'关注'】5月11日，中国大唐集团新能源股份有限公司发布《董事名单与其角色和职能》公告，陈飞虎因工作调整，已辞任公司非执行董事及董事长职务。寇伟接替陈飞虎，成为大唐新能源非执行董事及董事长。陈飞虎...	中国大唐集团新能源股份有限公司directorsData_title	董事	董事长。陈飞虎. . .
.李欣道 辽宁鸿利房地产开发集团有限公司董事长  .边华才 中凯企业集团董事长  .白文华 上海世博土地控股有限公司董事长  .包广林(包广林博客,包广林新闻,包广林说吧) 江苏新能源置业集团有限公司董事长  .倪居华 华纺房地产开发公司总...	江苏新能源置业集团有限公司shareholdersData_name	包广林	倪居华, 华纺房地产开发公司总. . .
江苏振江新能源装备股份有限公司第二届监事会第四次会议决议公告	江苏振江新能源装备股份有限公司directorsData_title	监事	监事会第四次会议决议公告😎
2007年4月16日,陕西法门寺文化景区建设有限公司正式成立时,总注册资金11亿。其中,西安曲江文化产业投资(集团)有限公司出资3亿元,占股份的27.27%,资金的其余部分,在政府的协调下,由陕西延长石油(集团)有限责任公司、金堆城钼业集团有限...	陕西延长石油(集团)有限责任公司investRecordData_logoWord	文化产业	石油(集团) 有限责任公司, 金堆城钼业集团有限. . . 😎
8、山东大海新能源发展有限公司  董事长:陈文杰 成立时间:2009年10月30日 企业简介:大海新能源系山东大海集团控股子公司,经营范围为太阳能硅片的生产和销售;自营、代理货物的进出口业务,电池片、光伏组件及系统集成研发、销售等,是一家...	山东大海新能源发展有限公司shareholdersData_logoWord	大海	大海集团控股子公司, 经营范围为太阳能硅片的生产和销售; 自营, 代理
山口武将出任东风日产乘用车总经理,北京商报讯(记者 刘洋 刘晓梦)4月29日,东风汽车有限公司宣布公司管理层人事调整,以进一步强化东风有限领导团队,推进东风有限事业计划实施。其中,日产汽车公司特殊项目企业副总裁山口武将出任东风汽车有……	东风汽车有限公司investRecordData_logoWord	东风汽车	汽车有限公司宣布公司管理层人事调整, 以进一步强化东风有限领导团队
9月30日,河南科隆新能源股份有限公司(简称科隆新能源)科创板IPO获上交所受理。 据招股说明书披露,科隆新能源本次科创板IPO拟发行1.06亿股,共拟募资6.13亿元,全部用于三大项目:年产1.2万吨高性能动力电池三元前驱体建设项目、年产400...	河南科隆新能源股份有限公司shareholdersData_logoWord	科隆	科隆新能源股份有限公司(简称科隆新能源) 科创板ipo获上交所受理。,
中国节能与新能源汽车关键零部件供应商——湖南科力远新能源股份有限公司(SH.600478)表示,已收到中国证监会批复,核准公司非公开发行不超过157,232,704股新股,总金额不超过15亿元。  根据定增方案,定增资金将用于动力电池、泡沫镍项目的...	湖南科力远新能源股份有限公司logoWord	科力远	科力远新能源股份有限公司(sh. 600478) 表示, 已收到中国证监会批复
陕西延长石油(集团)有限责任公司招标中心、陕西德源招标有限责任公司〔以下简称“招标中心(公司)”〕是由陕西延长石油(集团)有限责任公司组建的一个集约、规范、专业的招标代理服务机构,主要承担延长石油集团所属各单位限额上的招标项目及重大...	陕西延长石油(集团)有限责任公司logoWord	石油	石油(集团) 有限责任公司招标中心, 陕西德源招标有限责任公司〔以下
【能源人都在看，点击右上角加'关注'】近日，包头稀土高新区管委会与国电电力内蒙古新能源开发有限公司通过快递文本的方式完成了《红泥井百万千瓦清洁能源基地项目框架协议书》的签订。双方将依托国电电力在技术、资金、人才和管理方面的优势...	国电电力内蒙古新能源开发有限公司logoWord	国电电	国电电力内蒙古新能源开发有限公司通过快递文本的方式完成了《红泥井
1、中兴通讯股份有限公司(以下简称 ”公司”或”中兴通讯”)为全资子公司中兴通讯(香港)有限公司(以下简称”中兴香港”)的银行授信额度提供担保2005年12月,公司董事会审议通过以公司出具担保函形式为公司全资子公司中兴香港300万美元银行授...	中兴通讯股份有限公司holdsData_logoWord	中兴通讯	中兴通讯(香港) 有限公司(以下简称中兴香港) 的银行授信额度提
上证报中国证券网讯(记者宋薇萍)国网上海市电力公司副总经理吴英姿3月2日在上海市政府新闻发布会上表示，国网上海市电力公司全面推动电力工程的项目建设。目前，上海电网各类基建项目已逐步有序开工，整体开工率超过了80%。“我们正积极加快...	国网上海市电力公司holdsData_logoWord	国网上海	国网上海市电力公司副总经理吴英姿3月2日在上海市政府新闻发布会上
湖南省稀土产业集团有限公司注册资本为人 民币 3 亿元,其中湖南科力远新能源股份有限公司 占股 30%,与占股 30%的湖南黄金集团有限责任公 司同为第一大股东.湖南省稀土产业集团主业范 围有:稀土资源的勘探及其矿产品,副产品的采选,...	湖南科力远新能源股份有限公司holdsData_logoWord	科力远	科力远新能源股份有限公司, 占股, 30% 😎
任杭州鼎成铝业有限公司(江苏鼎胜新能源材料股份有限公司的全资子公司)材料、成本、税务会计;2007 年 8 月至 2014 年 6 月,任杭州五星铝业有限公司(江苏鼎胜新能源材料股份有限公司的全资子公司)财务经理;2014 年 6 月至今,任公司...	江苏鼎胜新能源材料股份有限公司holdsData_logoWord	鼎成铝业	鼎成铝业有限公司(江苏鼎胜新能源材料股份有限公司的全资子公司) 材
8月20日,坚瑞沃能发公告称,为适应公司重整后的战略规划跟经营发展需要,公司拟将公司名称、证券简称及注册资本等做相应的变更:公司名称变更为保力新能源科技股份有限公司,中文名简称“保力新”,注册资本由45.00亿元变更为42.81亿元,公司...	保力新能源科技股份有限公司investRecordData_logoWord	保力新	保力新能源科技股份有限公司, 中文名简称保力新, 注册资本由45.
郑州知名高新技术企业(部分) 序号企业名称 1郑州宇通客车股份有限公司 2郑州磨料磨具磨削研究所有限公司 3郑州单点科技软件有限公司 4郑州日产汽车有限公司 5郑州机械研究所 6郑州后羿制药有限公司 ...	郑州宇通客车股份有限公司logoWord	宇通客车	宇通客车股份有限公司, 2郑州磨料磨具磨削研究所有限公司, 3郑州单
每经AI快讯，捷佳伟创（SZ 300724，最新价：129.99元）1月8日午间发布公告称，2020年12月25日，深圳市捷佳伟创新能源装备股份有限公司在巨潮资讯网披露了《关于获得政府补助的公告》，其中尚未实际收到的政府补助资金为人民币约587万元...	深圳市捷佳伟创新能源装备股份有限公司logoWord	捷佳伟创	捷佳伟创新能源装备股份有限公司在巨潮资讯网披露了《关于获得政府补
证券代码:300118证券简称:东方日升公告编号:2019-143东方日升新能源股份有限公司2019年第三季度报告披露提示性公告本公司及董事会全体成员保证信息披露的内容真实、准确、完整,没有虚假记载、误导性陈述或重大遗漏。	东方日升新能源股份有限公司directorsData_title	董事	董事会全体成员保证信息披露的内容真实, 准确, 完整, 没有虚假记载,
近日据国网上海市电力公司、国网陕西省电力公司官网“公司领导”栏目更新显示:原任网陕西省电力公司董事长、党委书记梁旭,调任国网上海市电力公司董事长、党委书记,至此空缺了三个月的国网上海市电力公司董事长、党委书记职位补齐;原任国...	国网上海市电力公司logoWord	国网上	国网上海市电力公司董事长, 党委书记职位补齐; 原任国. . . 😎
蕴涵扬州深厚历史底蕴的城市宣传片,为发布会现场嘉宾展示了一段“与Young州共生”的归心之旅。回味之余,扬州市房地产商会会长、市慈善总会副会长、江苏新能源置业集团有限公司董事长包广林先生发表主题演讲,讲述了23年来,新能源置业在扬州...	江苏新能源置业集团有限公司shareholdersData_name	包广林	包广林先生发表主题演讲, 讲述了23年来, 新能源置业在扬州. . . 😎
19日,庞旭与中国水电建设集团新能源开发有限责任公司党委书记、董事长、总经理吴洵,副总经理吕东东会谈时表示,水电四局近年来在巩固传统业务的同时,不断实施转型升级发展,业务范围拓展到新能源、高速公路、高铁、地铁、水环境治理等领域。	中国水电建设集团新能源开发有限责任公司directorsData_title	总经理	董事长, 总经理吴洵, 副总经理吕东东会谈时表示, 水电四局近年来在巩
2021年4月27日,东方日升新能源股份有限公司发布《2020 年年度报告》。年报信息显示,报告期内,公司年度研发创新目标顺利完成,并有效应用于生产,主要的研发项目如下: (1)电池片研发方面:“B扩表面钝化技术的研究”、“B扩表面钝化接触的...	东方日升新能源股份有限公司logoWord	东方日升	东方日升新能源股份有限公司发布《2020, 年年度报告》。年报信息显示,
日前，盖世汽车了解到，比亚迪正式成立了弗迪实业有限公司（下称弗迪实业）。据企查查公开的信息显示，弗迪实业是比亚迪股份有限公司的全资子公司，成立于2020年12月11日，注册资本5亿元，法定代表人为弗迪系的大佬、弗迪品牌的董事长何龙。...	比亚迪股份有限公司logoWord	比亚迪	比亚迪股份有限公司的全资子公司, 成立于😎😎😎
华经产业研究院数据显示:2021年1月长城汽车股份有限公司汽车发动机生产量为121200辆,环比下降18.84%,同比增长121.46%;销售量为120524辆,环比下降19.05%,同比增长110.42%。 数据来源:中国汽车工业协会,华经产业研究院整理 ...	长城汽车股份有限公司investRecordData_logoWord	长城汽车	长城汽车股份有限公司汽车发动机生产量为121200辆😎😎😎
...日产|东风日产乘用车公司|东风汽车有限公司|中国市场|副总裁	东风汽车有限公司logoWord	汽车	汽车有限公司| 中国市场| 副总裁😎
学校始终十分重视和珍惜双方之间的合作关系，也非常感谢国网上海市电力公司一直以来给予上海电力大学的大力支持和帮助。他表示，此次学校与国网上海电力公司工程管理硕士联合培养合作协议的签署，标志着双方将进一步探索“产教融合、校企合作、...	国网上海市电力公司logoWord	国网上	国网上海电力公司工程管理硕士联合培养合作协议的签署, 标志着双方将
（3）独立监事罗金莉因年龄原因辞去独立监事职务，同时选举刘倩为本公司第六届监事会独立监事。（4）2019年3月，长城汽车股份有限公司副总经理郝建军，担任保定市长城控股集团有限公司旗下的保定市长城实业有限公司董事长，负责相关业务。（5...	长城汽车股份有限公司directorsData_title	董事长	董事长, 负责相关业务。（5. . .
2019 年第二次临时股东大会审议通过,东风科技拟通过向零部件集团全体股东东风汽车有限公司(以下简称“东风有限”)及深圳市东风南方实业集团有限公司(以下简称“南方实业”)发行股份的方式吸收合并零部件集团并募集配套资金(以下简称“本次...	东风汽车有限公司shareholdersData_logoWord	汽车	汽车有限公司(以下简称东风有限) 及深圳市东风南方实业集团有限
4月14日,永胜县与中国三峡新能源(集团)股份有限公司南方分公司举行合作框架协议签约仪式。 永胜县委常委、常务副县长陈元文对三峡新能源(集团)南方分公司总经理曾一行的到来表示热烈欢迎,并介绍了永胜县的资源优势和发展需求。他说,三峡...	中国三峡新能源(集团)股份有限公司directorsData_title	总经理	总经理曾一行的到来表示热烈欢迎, 并介绍了永胜县的资源优势和发展需
齐鲁晚报9月11日讯(记者 蒋龙龙)11日,从济南热力公司获悉,济南热力与山东地矿新能源有限公司合作成立了山东德和地热开发有限公司,该公司将着力开发临港经济开发区地热田。临港经济开发区有望用上地热供暖。	山东地矿新能源有限公司investRecordData_logoWord	德和地热	德和地热开发有限公司, 该公司将着力开发临港经济开发区地热田。临港
东风汽车集团有限公司(以下简称“东风公司”)谋定而后动,正式发布“东方风起”计划,科技创新“跃迁行动”为新能源和智能驾驶而来,开启创新转型发展的新纪元。与此同时,东风汽车集团股份有限公司(以下简称“东风集团”)A股上市在即。 实际...	东风汽车集团有限公司logoWord	汽车	汽车集团股份有限公司(以下简称东风集团) a股上市在即。, 实际
生态环境部(国家核安全局)与中国广核集团有限公司开展高层工作交流	中国广核集团有限公司logoWord	广核	广核集团有限公司开展高层工作交流😎
格隆汇 7 月 21日丨帝科股份(300842.SZ)公布，公司于近日收到《河北省保定市中级人民法院通知书》((2020)冀06破1-7号)，涉及公司客户英利能源(中国)有限公司(“英利中国”)和海南英利新能源有限公司(“海南英利”)被裁定实质合并...	海南英利新能源有限公司shareholdersData_name	英利能源(中国)有限公司	英利能源(中国) 有限公司(英利中国) 和海南英利新能源有限公司
调研对象主要是苏州捷力新能源材料有限公司,根据公司调研活动记录表,2018年4月公司任命李少庭先生为苏州捷力总经理,通过加强内部管控,发挥胜利精密的智能制造能力,已帮助苏州捷力完成改善工艺、提升产能,稳定并激励团队,以及为国际客户定制研发...	苏州捷力新能源材料有限公司directorsData_name	李少庭	李少庭先生为苏州捷力总经理, 通过加强内部管控, 发挥胜利精密的智能
央广网哈瓦那9月27日消息(记者 马喆 邢斯嘉)据中国之声《新闻和报纸摘要》报道,当地时间9月25号下午,国务院总理李克强在古巴首都哈瓦那体验中国出口的宇通客车,考察中国装备“走出去”情况。郑州宇通客车股份有限公司是较早进入拉美和加勒比...	郑州宇通客车股份有限公司shareholdersData_logoWord	宇通	宇通客车股份有限公司是较早进入拉美和加勒比. . .
潍柴动力(02338.HK):经中国证监会核发的《关于核准潍柴动力股份有限公司非公开发行股票的批复》(证监许可[2021]1407号),潍柴动力股份有限公司非公开发行不超过793387389股新股。本次发行实际发行数量为792682926股,每股面值1元,发行价格为每...	潍柴动力股份有限公司holdsData_logoWord	潍柴动力	潍柴动力(02338. hk) : 经中国证监会核发的《关于核准潍柴动力股份有
每经AI快讯,国新能源(SH 600617,收盘价:3.97元)4月28日晚间发布公告称,根据山西省国新能源股份有限公司实际业务发展融资需要,公司董事会同意全资子公司山西天然气有限公司、山西国新城市燃气有限公司和控股子公司山西煤层气(天然气)集...	山西省国新能源股份有限公司investRecordData_entName	山西国新城市燃气有限公司	山西天然气有限公司, 山西国新城市燃气有限公司和控股子公司山西煤层
鲍毓明退出中兴通讯股份有限公司董事行列 曾遭司法部点名:取得...	中兴通讯股份有限公司holdsData_logoWord	中兴通讯	中兴通讯股份有限公司董事行列, 曾遭司法部点名: 取得. . . 😎
今年,随着脱贫攻坚战取得全面胜利,河南省作为乡村振兴战略实施主战场,正全力打造农业大省乡村振兴典范。国网河南省电力公司紧紧围绕国家电网有限公司和省委、省政府要求,按照“乡村振兴,电力先行”发展理念,持续加大农村电网投资力度,持续提升...	国网河南省电力公司holdsData_logoWord	国网河南	国网河南省电力公司紧紧围绕国家电网有限公司和省委, 省政府要求, 按
奥特佳:子公司南京奥特佳新能源科技有限公司成为一汽-大众汽车有限公司供应商,将为其提供提供电动空调压缩机产品。 相关搜索 佳仕美新能源汽车 格力空调压缩机 上海大众 大众cc 新能源股票有哪些 一汽奔腾 ...	南京奥特佳新能源科技有限公司holdsData_logoWord	奥特佳	奥特佳新能源科技有限公司成为一汽-大众汽车有限公司供应商, 将为其
潍柴动力股份有限公司创建于2002年,总部位于山东潍坊,是中国第一家在香港联交所主版上市的内燃机企业,也是中国最大的汽车零部件企业集团。潍柴动力(潍坊)集约配送有限公司成立于2005年10月,目前担负潍柴集团的主要采购物流、生产物流和销售...	潍柴动力股份有限公司investRecordData_entName	潍柴动力(潍坊)集约配送有限公司	潍柴动力(潍坊) 集约配送有限公司成立于2005年10月, 目前担负潍柴集团
苗连生 职务:河北保定天威英利新能源有限公司总裁 联系方式 申报理由:打造了中国首座太阳能大厦——电谷锦江酒店 中国首座太阳能大厦——电谷锦江酒店2008年10月18日正式投入使用以来,酒店的发电量已达到30万千瓦时,相当于节约标准煤110吨,...	保定天威英利新能源有限公司investRecordData_logoWord	天威英利	天威英利新能源有限公司总裁, 联系方式, 申报理由: 打造了中国首座太
潍柴动力:潍柴动力股份有限公司独立董事关于公司是否存在同业竞争...	潍柴动力股份有限公司logoWord	潍柴动力	潍柴动力股份有限公司独立董事关于公司是否存在同业竞争. . . 😎
深康佳A: 康佳集团股份有限公司拟股权转让涉及的深圳市康新置业...	康佳集团股份有限公司holdsData_logoWord	康佳	康佳a: , 康佳集团股份有限公司拟股权转让😎
作为原东风汽车有限公司总裁,内田诚在连线开场直言自己视中国为“第三祖国”。不过,如今他更愿意在日产全球框架下定义中国市场的重要性。 交流中,内田诚不避讳日产汽车面临的问题,主动提出2019财年日产汽车经营状况出现了较大损失。虽然有困...	东风汽车有限公司investRecordData_logoWord	东风汽车	汽车有限公司总裁, 内田诚在连线开场直言自己视中国为第三祖国。
12月14日，上海电力大学党委书记李明福，党委副书记、校长李和兴赴国网上海市电力公司拜会了国网上海市电力公司董事长、党委书记梁旭，董事、总经理、党委副书记阮前途。李明福介绍了学校近期发展概况，表示学校在办学的历程中，始终坚持“...	国网上海市电力公司legalPerson	梁旭	梁旭, 董事, 总经理, 党委副书记阮前途。李明福介绍了学校近期发展概
定州市 先进集体 石家庄市发展和改革委员会 石家庄市行政审批局 石家庄市中级人民法院民事审判第四庭 石家庄市司法局 石家庄市市场监督管理局 石家庄市鹿泉海关综合业务一科 国家税务总局石家庄市税务局 国网河北省电力有限公司石家庄供电分...	国网河北省电力有限公司investRecordData_logoWord	国网河	国网河北省电力有限公司石家庄供电分. . . 😎😎😎😎😎😎
2020年11月3日,中检集团副总裁、中国质量认证中心主任陆梅赴珠海格力电器股份有限公司(以下简称“格力电器”)拜访调研,并与格力电器董事长董明珠女士及相关部门进行了座谈。 会上,陆梅介绍了中检集团的组织架构、业务领域以及国资委对集团的...	珠海格力电器股份有限公司directorsData_title	董事	董事长董明珠女士及相关部门进行了座谈。, 会上, 陆梅介绍了中检集团
地点:南港展览馆1馆503会议室(台北市南港区经贸二路1号5楼) 报名网页:https://www.accupass.com/event/1909030942531703139789 主办单位:爱士惟新能源技术(江苏)有限公司 协办单位:EnergyTrend、TrendForce ...	爱士惟新能源技术(江苏)有限公司investRecordData_logoWord	爱士惟	爱士惟新能源技术(江苏) 有限公司, 协办单位: energy😎😎
东风访谈 | 东风汽车集团有限公司董事长、党委书记竺延风:岚图是...	东风汽车集团有限公司logoWord	汽车	汽车集团有限公司董事长, 党委书记😎
日前,网通社从上海联合产权交易所获悉,一汽吉林汽车有限公司增资项目落定,山东宝雅新能源汽车股份有限公司投资15亿元,获得一汽吉林70.5%的股权。 一汽吉林此前在上海产权交易所挂牌交易,为募集15亿元资金拟转让70%股权。在多家投资者竞标中...	山东宝雅新能源汽车股份有限公司investRecordData_regRate	70%	70% 股权。在多家投资者竞标中. . .
淄博泰威能源科技有限公司总经理孙波、浙江碳银互联网科技有限公司董事长俞兆洪、江苏固德威电源科技有限公司副总经理侯祥勇、爱士惟新能源技术(江苏)有限公司山东区域总监朱平、新驰电气集团有限公司北方大区总监马康强就此话题进行了热烈的...	爱士惟新能源技术(江苏)有限公司investRecordData_logoWord	爱士惟	爱士惟新能源技术(江苏) 有限公司山东区域总监朱平, 新驰电气集团有
近日，有多家媒体报道，银隆新能源股份有限公司发生工商变更，董明珠从股东中退出。针对这一传闻，银隆新能源声明称这些信息严重失实，公司股东董明珠股权未发生任何变更。电车汇通过国家企业信用信息公示系统查询到，格力电器董事长董明珠目前仍...	银隆新能源股份有限公司directorsData_title	董事	董事长董明珠目前仍. . . 😎
...建投证券股份有限公司关于国家电投集团东方新能源股份有限公司...	国家电投集团东方新能源股份有限公司investRecordData_logoWord	国家电投	国家电投集团东方新能源股份有限公司. . . 😎
光合联萌 指 光漾联萌互联网金融信息服务(上海)有限公司,系公司全资公司 公司章程 指 东方日升新能源股份有限公司章程 2016 年度定增事项 指 2016 年度非公开发行股票事项 股权激励计划 指 东方日升首期限制性股票激励计划 ...	东方日升新能源股份有限公司investRecordData_logoWord	东方日升	东方日升新能源股份有限公司章程, 2016, 年度定增事项, 指, 2016, 年度非
我坚信在这个伟大的时代,‘创维汽车’必将成为不凡的民族品牌,中国汽车品牌也将引领世界新能源汽车产业御风而行,为世界人民的福祉贡献坚实的力量。” 开沃新能源汽车集团股份有限公司常务副总裁、酷沃智行科技有限公司董事长董钊志先生表示:...	开沃新能源汽车集团股份有限公司directorsData_title	董事	董事长董钊志先生表示: . . .
深交所向珈伟新能源股份有限公司实际控制人丁孔贤发出监管函	珈伟新能源股份有限公司directorsData_name	丁孔贤	丁孔贤发出监管函😎
三、招标内容:广汇能源股份有限公司下属公司(新疆广汇新能源有限公司、新疆广汇煤炭清洁炼化有限责任公司、新疆广汇陆友硫化工有限公司、新疆广汇液化天然气发展有限责任公司、伊吾广汇矿业有限公司、新疆广汇能源综合物流发展有限责任公司)2020年...	新疆广汇新能源有限公司holdsData_logoWord	广汇矿业	广汇能源股份有限公司下属公司(新疆广汇新能源有限公司, 新疆广汇煤
品牌整合!东风汽车有限公司迎来重大变动	东风汽车有限公司investRecordData_logoWord	汽车	汽车有限公司迎来重大变动
11月16日晚间,郑州宇通客车股份有限公司发布关于聘任高级管理人员的公告,根据经营需要,宇通客车第十届董事会第四次会议聘任曹中彦为公司副总经理。曹中彦由公司董事长兼总经理汤玉祥提名,任期自董事会审议通过之日起,至本届董事会任期届满...	郑州宇通客车股份有限公司logoWord	宇通客车	宇通客车股份有限公司发布关于聘任高级管理人员的公告, 根据经营需要
SNEC第十二届(2018)国际太阳能光伏与智慧能源(上海)大会暨展览会将于5月28-30日在上海举办。“中国好光伏”获奖企业特变电工新疆新能源股份有限公司将重磅发行全新一代SolarHome系列以及全球首台户外集中式逆变器,携Solarpoint分布式智慧...	特变电工新疆新能源股份有限公司logoWord	特变电工	特变电工新疆新能源股份有限公司将重磅发行全新一代solarhome系列以及全
在稀土资源综合利用方面,目前,我州开发利用稀土资源的企业主要有四川江铜稀土有限公司、四川万凯丰稀土新能源科技有限公司等6户,2010年稀土精矿生产冶炼分离能力分别达到3.36万吨和1.4万吨。 黄润秋在听取汇报后指出,通过多年的不懈努力,...	四川万凯丰稀土新能源科技有限公司logoWord	万凯丰	万凯丰稀土新能源科技有限公司等6户, 2010年稀土精矿生产冶炼分离能力
保利协鑫(苏州)新能源有限公司 法务高级经理 3 刘浩 保利协鑫(苏州)新能源有限公司 法务高级经理 4 聂琛 徐州市科诺医学仪器设备有限公司 法务经理 5 祖家志 徐工集团工程机械股份有限公司	保利协鑫(苏州)新能源有限公司investRecordData_logoWord	保利协鑫	保利协鑫(苏州) 新能源有限公司, 法务高级经理, 3, 刘浩, 保利协鑫
州委书记姚国华在蒙自会见云南电网有限责任公司党委书记、董事长甘霖一行。 姚国华对甘霖一行的到访表示欢迎,对云南电网公司长期支持红河州经济社会发展表示感谢。他说,近年来,云南电网公司红河供电局在红河州经济发展的支持上、社会民生的保障...	云南电网有限责任公司logoWord	电网	电网有限责任公司党委书记, 董事长甘霖一行。, 姚国华对甘霖一行的到
公司于2021年4月22日收到控股股东中国广核集团有限公司(以下简称“中广核”)《关于中国广核电力股份有限公司2020年度股东大会临时提案的函》,提议将本公司第三届董事会第七次会议审议通过的《关于审议第三届董事会新增一名独立董事候选人的...	中国广核集团有限公司investRecordData_logoWord	广核电力	中广核) 《关于中国广核电力股份有限公司2020年度股东大会临时提案的
(以下简称“本所”)接受潍柴动力股份有限公司(以下简称“公司”)的委托,指派律师出席公司于2007 年6 月19 日召开的2007 年度股东周年大会(以下简称“本次股东大会”),并就本次股东大会的有关事宜,出具法律意见书。	潍柴动力股份有限公司holdsData_logoWord	潍柴动力	潍柴动力股份有限公司(以下简称公司) 的委托, 指派律师出席公司
...潍柴动力股份有限公司分拆所属子公司潍柴火炬科技股份有限公司...	潍柴动力股份有限公司logoWord	潍柴动力	潍柴动力股份有限公司分拆所属子公司潍柴火炬科技股份有限公司. . .
2016年，“格力130亿元收购银隆100%股权”的提议在股东大会上被否决后，董明珠宣布以个人名义投资，并拉来好友王健林、刘强东，共出资30亿元入股。这三个车圈门外汉成为了珠海银隆的股东，而珠海银隆也更名为银隆新能源股份有限公司。虽然都...	银隆新能源股份有限公司shareholdersData_name	董明珠	董明珠宣布以个人名义投资, 并拉来好友王健林, 刘强东, 共出资30亿元
2019届毕业生：翟吉蕾，现工作于山东力诺瑞特新能源有限公司。感言：学习上，有教学经验丰富的老师的指导，稳步吸收专业知识，同时利用各种实验和科创比赛锻炼动手能力；思想上，光荣的成为共产党员，在亲切幽默的导员引导下，树立了正确的...	山东力诺瑞特新能源有限公司investRecordData_logoWord	力诺瑞特	力诺瑞特新能源有限公司。感言：学习上, 有教学经验丰富的老师的指导
江苏鼎胜新能源材料股份有限公司(以下简称“本公司”)于2020年4月27日 召开第四届董事会第二十七次会议审议通过了《关于向全资子公司增资扩股的议 案》。公司拟以自有资金向全资子公司内蒙古联晟新能源材料有限公司(以下简...	江苏鼎胜新能源材料股份有限公司directorsData_title	董事	董事会第二十七次会议审议通过了《关于向全资子公司增资扩股的议, 案
2020年12月30日,人民银行杭州中心支行行长殷兴山、人民银行宁波市中心支行行长张全兴一行莅临东方日升新能源股份有限公司参观调研,宁海县副县长应国邦等陪同考察。 一行人先后参观了东方日升研发中心与点点云智能科技有限公司的电站运维集控中心...	东方日升新能源股份有限公司holdsData_logoWord	东方日升	东方日升研发中心与点点云智能科技有限公司的电站运维集控中心. . .
我们审计了潍柴动力股份有限公司的财务报表,包括2016年12月 31 日的合并及公司的资产负债表, 2016年度合并及公司利润表、股东权益变动表和现金流量表以及相关财务报表附注。 我们认为,后附的潍柴动力股份有限公司的财务报表在所有重大方面按...	潍柴动力股份有限公司investRecordData_logoWord	潍柴动力	潍柴动力股份有限公司的财务报表在所有重大方面按. . .
中兴的智能汽车版图包括:中兴通讯股份有限公司(5G,C-V2X 技术;C-V2X 模组和 OBU 通过新四跨测试)、中兴新能源汽车有限责任公司(无线充电、充电桩电源模块;充电模块峰值效率第一,无线 充电示范线路开始运行)、中兴高能技术有限责任公司(...	中兴通讯股份有限公司holdsData_entName	中兴高能技术有限责任公司	中兴通讯股份有限公司(5g, c-v2x, 技术; c-v2x, 模组和, obu
而“驱动制动装置及具有其的汽车”的专利摘要显示，其消除了高速连接处油封困难的问题，使得电机组件的发热体直接与冷却油接触，传热效率大大提升。  天眼查APP显示，珠海格力电器股份有限公司成立于1989年12月，法定代表人为董明珠，注册...	珠海格力电器股份有限公司logoWord	格力电器	格力电器股份有限公司成立于1989年12月, 法定代表人为董明珠, 注册. .
红网时刻6月2日讯（记者 姜心玥 通讯员 李湘晖）近日，湖南高创新能源有限公司IPO启动签约仪式成功举行。高创新能源公司董事长杨翊与中信证券、天职会计师事务所、启元律师事务所三家中标IPO辅导工作的机构逐一签约。签约仪式后，高新创投...	湖南高创新能源有限公司directorsData_title	董事长	董事长杨翊与中信证券, 天职会计师事务所, 启元律师事务所三家中标ipo
《特变电工公司控股公司特变电工新疆新能源股份有限公司投资建设...	特变电工新疆新能源股份有限公司logoWord	特变电工	特变电工新疆新能源股份有限公司投资建设. . . 😎
(3)会计估计变更对财务报表的主要影响如下: 珠海格力电器股份有限公司 证券代码:000651 证券简称:格力电器 公告编号...五,独立董事独立意见 公司独立董事刘姝威女士,王晓华先生,邢子文先生认真审阅了上述关联交易的相关材料,同意将上述关联...	珠海格力电器股份有限公司logoWord	格力电器	格力电器股份有限公司, 证券代码: 000651😎
*ST兆新 公告编号:2020-209 深圳市兆新能源股份有限公司关于对深圳证券交易所关注函回复的公告 本公司及董事会全体...深圳市兆中海智慧停车充电投资有限公司 82% 11 河北兆腾气雾剂科技有限公司 60% 12 深圳市兆威新能源科技有限责任...	深圳市兆新能源股份有限公司investRecordData_entName	深圳市兆中海智慧停车充电投资有限公司	深圳市兆中海智慧停车充电投资有限公司, 82% , 11, 河北兆腾气雾剂科
2008年,袁海科任陕西延长石油(集团)油田股份有限公司董事、总经理、党委副书记,任职5年,于2013年出任陕西延长石油(集团)有限责任公司副总经理,至此番被查。 今年4月15日,延长石油集团公司召开领导干部违规插手干预工程建设和矿产开发突出问...	陕西延长石油(集团)有限责任公司logoWord	石油	石油(集团) 有限责任公司副总经理, 至此番被查。, 今年4月15日, 延
龙岩卓越新能源股份有限公司(以下简称“公司”或“卓越新能”)及下属子公司厦门卓越生物质能源有限公司(以下简称“厦门卓越”)、福建致尚生物质材料发展有限公司(以下简称“福建致尚”)自2020年12月25日至2021年3月5日,...	龙岩卓越新能源股份有限公司holdsData_entName	福建致尚生物质材料发展有限公司	厦门卓越生物质能源有限公司(以下简称厦门卓越) , 福建致尚生物
湖北弘元光伏科技有限公司,湖北天合的曾用名 湖北天合 指湖北天合光能有限公司 常州捷佳创 指常州捷佳创精密机械有限公司 深圳创翔 指深圳市创翔软件有限公司 《公司章程》 指《深圳市捷佳伟创新能源装备股份有限公司章程》 ...	深圳市捷佳伟创新能源装备股份有限公司investRecordData_logoWord	天合光能	天合光能有限公司, 常州捷佳创, 指常州捷佳创精密机械有限公司, 深圳
今年以来，东风汽车有限公司通过开展党建活动，充分发挥党员先锋模范作用，厚植国有企业发展的“根”与“魂”，以党建引领激发企业的竞争优势、发展优势，为生产经营保驾护航。　　今年10月，东风汽车有限公司达成145895辆的销量成绩，同比...	东风汽车有限公司investRecordData_logoWord	汽车	汽车有限公司通过开展党建活动, 充分发挥党员先锋模范作用, 厚植国有
国企直聘丨陕西延长石油(集团)有限责任公司招标中心招聘公告	陕西延长石油(集团)有限责任公司logoWord	石油	石油(集团) 有限责任公司招标中心招聘公告😎
每股面值人民币1.00元,发起人投入公司的资产为134,994.91万元,负债为95,908.11万元,净资产折为股本39,000万股,未折入股本的86.80万元计入公司的资本公积金;其他事项仍按照《关于同意设立比亚迪股份有限公司的批复》(国经贸企改[2002...	比亚迪股份有限公司logoWord	比亚迪	比亚迪股份有限公司的批复》(国经贸企改[2002. . .
(二)云南电网有限责任公司工会 举办单位:丽江华坪供电局工会 活动主题:红色教育、党性教育、向身边的榜样学习 活动内容:邀请张桂梅进行面对面学习交流,向榜样学习、向楷模致敬! 举办单位:德宏供电局 ...	云南电网有限责任公司holdsData_logoWord	德宏供电	供电局工会, 活动主题: 红色教育, 党性教育, 向身边的榜样学习, 活动
作者:深圳古瑞瓦特新能源股份有限公司 时间:2016-12-22 我要发布 小 中 大 关键词: 光伏逆变器 光伏逆变器主要由印刷线路板、IGBT、直流母线电容器、液晶显示屏幕组成。为什么这样分类,主要是从部件寿命的角度出发。大部分的电阻、...	深圳古瑞瓦特新能源股份有限公司logoWord	古瑞瓦特	古瑞瓦特新能源股份有限公司, 时间: 2016-12-22, 我要发布, 小, 中,
长城汽车徐水分公司:讯 记者宋美倩、通讯员刘玉洁报道:“今年国家减税降费力度空前加大,企业发展动力更足了。”长城汽车股份有限公司徐水分公司总经理张利告诉记者,2019年全年企业预计能节约税费成本16526.43万元,此外个人所得税新政实施后,...	长城汽车股份有限公司investRecordData_logoWord	长城汽车	长城汽车股份有限公司徐水分公司总经理张利告诉记者, 😎😎😎😎😎
近日,公司副总经理张利一行赴青岛科创蓝新能源股份有限公司进行洽谈交流。青岛科创蓝新能源股份有限公司董事长迟芳等人出席了会谈。 会谈中,双方就组建魏县清洁能源供热项目SPV公司进行了协商,决定分别成立协调小组,制定联系机制,明确责任分工和...	青岛科创蓝新能源股份有限公司directorsData_name	迟芳	迟芳等人出席了会谈。, 会谈中, 双方就组建魏县清洁能源供热项目spv
黄 汪 安徽华米信息科技有限公司 总裁兼CEO  宋礼华 安徽安科生物工程有限公司 董事长、总经理 李培辉 安徽古井集团有限责任公司 总裁  臧 牧 安徽皖仪科技股份有限公司 董事长、总经理 艾和金 安徽爱瑞特新能源专用汽车股份有限公司 总...	安徽爱瑞特新能源专用汽车股份有限公司directorsData_name	艾和金	艾和金, 安徽爱瑞特新能源专用汽车股份有限公司, 总. . .
本公司及董事会全体成员保证信息披露的内容真实、准确和完整,没有虚假记载、误导性陈述或者重大遗漏。 深圳市捷佳伟创新能源装备股份有限公司2019年第一季度报告全文于2019年4月26日在中国证监会指定的创业板信息披露网站巨潮资讯网(www.cnin...	深圳市捷佳伟创新能源装备股份有限公司directorsData_title	董事	董事会全体成员保证信息披露的内容真实, 准确和完整, 没有虚假记载,
[摘要]全国人大代表、湖南科力远新能源股份有限公司董事长钟发平在接受记者采访时表示,中国的新能源汽车要发展得好,要实现弯道超车,新能源汽车财政补贴的发放最好是通过公开招标。 全国人大代表、湖南科力远新能源股份有限公司董事长钟发平在...	湖南科力远新能源股份有限公司logoWord	科力远	科力远新能源股份有限公司董事长钟发平在接受记者采访时表示, 中国的
上海泽昌律师事务所 经办律师: 石百新 负责人: 经办律师: 李福亮 刘波 年月日 证券代码:603507 证券简称:振江股份 公告编号:2018-069 江苏振江新能源装备股份有限公司 关于签署投资意向协议的公告 本公司董事会,全体董事及相关股东...	江苏振江新能源装备股份有限公司holdsData_logoWord	振江新能	振江新能源装备股份有限公司, 关于签署投资意向协议的公告, 本公司董
爱士惟新能源技术(江苏)有限公司 产品技术副总裁 吴生闻 据了解,爱士惟公司源自德系,曾属于全球知名太阳能逆变器厂家SMA集团在中国的全资子公司。2019年,爱士惟经由股权重组从SMA集团脱离集团独立运营,成为一家完全中国本土化的公司,但该...	爱士惟新能源技术(江苏)有限公司holdsData_logoWord	爱士惟	爱士惟新能源技术(江苏) 有限公司, 产品技术副总裁, 吴生闻, 据了解
见多识广的吕向阳最后认可了表弟的能力和想法,出资250万元并以第二大股东的身份与王传福一同创立了比亚迪股份有限公司,专注于锂离子电池的生产。 250万在当时是一笔巨款,但对于电池制造仍是杯水车薪。王传福总结出了自己的一套方法去解决...	比亚迪股份有限公司directorsData_name	吕向阳	吕向阳最后认可了表弟的能力和想法, 出资250万元并以第二大股东的身份
本报讯(记者袁铮)7月16日,我市与国网河北省电力有限公司签署《加快能源互联网建设打造河海相济动能强劲重要增长极战略合作框架协议》。国网河北省电力有限公司董事长、党委书记王昕伟,国网河北省电力有限公司总经理、党委副书记王罡,市委...	国网河北省电力有限公司holdsData_logoWord	国网河北	国网河北省电力有限公司总经理, 党委副书记王罡, 市委. . . 😎😎😎😎
一、公司简介 华能新能源股份有限公司山西分公司(以下简称“山西分公司”)是中国华能集团公司下属华能新能源股份有限公司在山西省的下设机构,负责公司在整个山西省新能源产业的开发和运营。公司下辖7个项目公司,建成及规划项目涉及山西省各市...	华能新能源股份有限公司branchsData_entName	华能新能源股份有限公司山西分公司	山西分公司(以下简称山西分公司) 是中国华能集团公司下属华能新
长江日报-长江网5月15日讯（记者李琴）5月15日上午，2020武汉“云招商”央企专场举行。中国广核集团有限公司总经理杨长利介绍，集团始终与武汉人民心连心，共患难。武汉是英雄的城市，武汉在区位、交通、人才等方面具有很大的优势，集团对...	中国广核集团有限公司legalPerson	杨长利	杨长利介绍, 集团始终与武汉人民心连心, 共患难。武汉是英雄的城市,
一主线:加强党组织的政治引领力、先进性和纯洁性建设;两聚焦:实现年度经营目标,破解生产经营和改革发展重点难点课题;两突出:党政合力攻坚,突出党建与经营的深度融合。前不久召开的东风汽车有限公司2021年第一季度党群工作例会上,发布了《20...	东风汽车有限公司shareholdersData_logoWord	汽车	汽车有限公司2021年第一季度党群工作例会上, 发布了《20. . . 😎😎
黄伟任东风汽车集团有限公司董事、党委副书记,澎湃新闻记者从东风汽车集团有限公司方面获悉:2021年4月26日,东风公司召开领导班子(扩大)会。受中组部委托,东风公司董事长、党委书记竺延风同志宣布了中组部关于干部任职的决定:黄伟任东风汽车...	东风汽车集团有限公司legalPerson	竺延风	竺延风同志宣布了中组部关于干部任职的决定: 黄伟任东风汽车. . . 😎
25日,由四川江铜稀土有限责任公司、四川万凯丰稀土新能源科技有限公司、凉山州国有投资有限责任公司等6家企业共同发起设立,集开采、冶炼分离、加工、研发于一体和具备完整产业链的大型稀土企业集团——“四川金攀西稀土(集团)有限责任公司”...	四川万凯丰稀土新能源科技有限公司investRecordData_logoWord	万凯丰	金攀西稀土(集团) 有限责任公司. . .
中兴通讯成立终端公司,由中兴通讯股份有限公司100%控制	中兴通讯股份有限公司investRecordData_regRate	100%	100% 控制😎
2016年9月16日至25日,盐城市发改委副主任顾光明、盐城市城市建设投资集团有限公司副董事长陈榕率江苏奥新新能源汽车有限公司(下面简称“奥新公司”)总经理史践、车型开发项目经理张焰峰、外国专家本帕克及专家室经理梁子靖,就轻量化新能...	江苏奥新新能源汽车有限公司directorsData_title	董事	董事长陈榕率江苏奥新新能源汽车有限公司(下面简称奥新公司) 总
江苏中信博新能源科技股份有限公司 保荐人(主承销商):安信证券股份有限公司 发行情况: 公司简介: 中信博控股股东为蔡浩,其直接持有中信博5089.37万股股份,持股比例为50.0004%;其配偶杨雪艳直接持有中信博股东融博投资31.23%的出资并为其...	江苏中信博新能源科技股份有限公司logoWord	中信博	中信博新能源科技股份有限公司, 保荐人(主承销商) : 安信证券股份有
(三)、深圳威迈斯新能源股份有限公司上会被否原因如下: 1,大客户关联交易问题: 扬州尚颀、同晟金源合计持有发行人7.93%股份。2018年发行人第一大客户上汽集团及其下属公司间接持有扬州尚颀、同晟金源股权及财产份额。请发行人代表说明:...	深圳威迈斯新能源股份有限公司logoWord	威迈斯	威迈斯新能源股份有限公司上会被否原因如下: , 1, 大客户关联交易问
《2015年国网河南省电力公司第二批招考公告》已于2015年2月28日正式向广大考生公布。本次考试共计划招考1362人,其中国家电网894人,许继集团338人,平高130人。本次招考采取网上报名方式,报名时间从2015年3月1日起,截止至2015年3月10日...	国网河南省电力公司logoWord	国网河	国网河南省电力公司第二批招考公告》已于2015年2月28日正式向广大考生
【能源人都在看，点击右上角加'关注'】5月25日，集团公司党委副书记、总经理吴伟章率队拜访了中国广核集团有限公司（简称中广核），与中广核党委副书记、总经理杨长利进行了深入交流。集团公司党委常委、副总经理吕智强参加座谈交流。吴伟章...	中国广核集团有限公司legalPerson	杨长利	杨长利进行了深入交流。集团公司党委常委, 副总经理吕智强参加座谈交
24日,佛山市天劲新能源科技有限公司在市高级技工学校举办专场招聘会,为即将毕业的莘莘学子提供就业机会,让他们更好地走向社会。 佛山市天劲新能源科技有限公司隶属于广东天劲新能源科技股份有限公司,董事长曾洪华是市高级技工学校的毕业生,...	广东天劲新能源科技股份有限公司investRecordData_entName	佛山市天劲新能源科技有限公司	佛山市天劲新能源科技有限公司在市高级技工学校举办专场招聘会, 为即
股份有限公司董事长王一鸣、爱士惟新能源技术(江苏)有限公司总裁张勇、浙江正泰新能源开发有限公司副总裁周承军、中智(泰兴)电力科技有限公司董事长彭德香、江苏日托光伏科技有限公司总裁张凤鸣、通威集团有限公司副总裁胡荣柱、国能日新科技...	爱士惟新能源技术(江苏)有限公司investRecordData_logoWord	爱士惟	爱士惟新能源技术(江苏) 有限公司总裁张勇, 浙江正泰新能源开发有限
特变电工:控股公司特变电工新疆新能源股份有限公司投资建设风能...	特变电工新疆新能源股份有限公司holdsData_logoWord	特变电工	特变电工新疆新能源股份有限公司投资建设风能. . . 😎
他就是国网南阳供电公司营销部营销业务质量管理专责刘旭中,连续三届国网河南省电力公司供电“十佳服务之星”(第五届、第六届、第七届),先后荣获省公司劳动模范、河南省技术能手、国家电网公司技术能手等荣誉。	国网河南省电力公司holdsData_logoWord	国网河南	国网河南省电力公司供电十佳服务之星(第五届, 第六届, 第七届)
湖南科力远新能源股份有限公司(以下简称"公司")于2018年4月11日以通讯表决方式召开第六届董事会第十次会议,审议通过了《关于第一期员工持股计划存续期展期一年的议案》,其中关联董事张聚东、刘彩云、刘滨、丸山弘美为员工持股计划参与对象...	湖南科力远新能源股份有限公司directorsData_name	张聚东	刘滨, 丸山弘美为员工持股计划参与对象. . .
作者:深圳古瑞瓦特新能源股份有限公司 时间:2020-07-22 我要发布 小 中 大 关键词: 逆变器 古瑞瓦特光伏逆变器厂家讲解光伏系统中的防逆流设备 在光伏系统中,能量的流动方向是光伏组件-逆变器-负载-电网,而在电网系统中,能量的...	深圳古瑞瓦特新能源股份有限公司investRecordData_logoWord	古瑞瓦特	古瑞瓦特光伏逆变器厂家讲解光伏系统中的防逆流设备, 在光伏系统中,
青岛即发集团股份有限公司 青岛达能环保设备股份有限公司 青岛钜源运动器材有限公司 中科航星科技有限公司 青岛义和钢构有限公司 青岛中集特种冷藏设备有限公司 青岛海泰科模具有限公司 青岛科创蓝新能源股份有限公司 ...	青岛科创蓝新能源股份有限公司investRecordData_logoWord	科创蓝	科创蓝新能源股份有限公司, . . . 😎
为深入贯彻落实市委、市政府与格力电器股份有限公司全面战略合作要求，提升我县智能制造装备水平和木业转型升级，近日，县委副书记、县长徐立峰带队到珠海格力电器股份有限公司深入对接，开展招商考察活动。市投资促进服务中心党组书记、主任刘春晨...	珠海格力电器股份有限公司investRecordData_logoWord	格力电器	格力电器股份有限公司深入对接, 开展招商考察活动。市投资促进服务中
他介绍,多氟多新能源科技有限公司(下称“多氟多新能源”)成立于2010年,主营汽车用动力锂离子电池、储能电池等,是奇瑞、东风、长城等中高端汽车制造厂的配套供应商,目前主要为奇瑞“小蚂蚁”提供软包电池产品。2015年到2018年,多氟多装机量...	多氟多新能源科技有限公司logoWord	多氟多	多氟多新能源科技有限公司(下称多氟多新能源) 成立于2010年, 主营
卢   明 国网河南省电力公司电力科学研究院设备状态评价中心专责 李武成 河南送变电建设有限公司输电第三施工分公司经理、党支部副书记 国家电网有限公司先进集体 国网河南省电力公司郑州供电公司 国网河南省电力公司洛阳供电公司 国网河...	国网河南省电力公司holdsData_logoWord	国网河南	国网河南省电力公司郑州供电公司, 国网河南省电力公司洛阳供电公司,
郄英才会见东风汽车有限公司副总裁、东风日产乘用车公司副总经理...	东风汽车有限公司investRecordData_logoWord	东风汽车	汽车有限公司副总裁, 东风日产乘用车公司副总经理. . . 😎
郑州宇通客车股份有限公司配股申请文件配股说明书声明本公司全体董事、监事、...金融危机的影响下,全球汽车消费市场大幅下滑,我国大中型客车市场销售增速 ...厦门、苏州、唐山、广州 7个试点城市进行公共服务领域节能与新能源汽车示范 ...	郑州宇通客车股份有限公司directorsData_title	董事	监事, . . . 金融危机的影响下, 全球汽车消费市场大幅下滑, 我国大中
根据国家电投集团东方新能源股份有限公司(以下简称“公司”)第六届董事会第二十二次会议决议,本公司将于2019年12月25日以现场结合网络投票方式召开2019年第四次临时股东大会,并已于2019年12月9日在《证券时报》、《中国证券报》、巨潮...	国家电投集团东方新能源股份有限公司logoWord	国家电投	国家电投集团东方新能源股份有限公司(以下简称公司😎
此额度在湖南科力远新能源股份有限公司(以下简称:“公司”或“股份公司”) 向中国建设银行湖南省分行申请60,000万元综合授信额度以内,其中,湖南科霸 汽车动力电池有限责任公司获授8,000万元,由股份公司提供担保,科霸公司以此 ...	湖南科力远新能源股份有限公司investRecordData_logoWord	科力远	科霸公司以此, . . . 😎
益阳高新区工委书记汪军，益阳高新区工委副书记、管委会主任周朗，湖南科力远新能源股份有限公司董事长钟发平，科力远高技术集团有限公司执行总裁张聚东出席签约仪式。此次签约的项目总投资达15亿元，选址为益阳高新区东部产业园鱼形山路以南...	湖南科力远新能源股份有限公司legalPerson	钟发平	钟发平, 科力远高技术集团有限公司执行总裁张聚东出席签约仪式。此次
珠海格力绿色再生资源有限公司由珠海格力电器股份有限公司百分百持股,董明珠间接持股0.74%。 值得关注的是,这并不是格力第一次投资成立再生资源公司,早在2010年8月26日,格力就成立了郑州格力绿色再生资源有限公司,法定代表人也是庄培,注册...	珠海格力电器股份有限公司holdsData_logoWord	格力电器	格力电器股份有限公司百分百持股, 董明珠间接持股0.74% 。, 值得关
记者进入环境气候模拟实验室中亲身体验格力空调在超低温状态下正常运行。(国新网 李昭 摄) 格力严把核心零部件质量关,图为大型零部件检测。(图片由珠海格力电器股份有限公司提供) 格力精密模具现服务于家电模具、马达铁芯、热交换器、汽车...	珠海格力电器股份有限公司logoWord	格力电器	格力电器股份有限公司提供) , 格力精密模具现服务于家电模具, 马达铁
2018年11月7日,江苏振江新能源装备股份有限公司(以下简称“公司”)与切斯特技术公司、JAMES MAOZHONG GU (顾茂众)、CHUNZHE LONG(龙纯喆)、上海底特精密紧固件股份有限公司(以下简称“上海底特”)签署了《江苏振江新能源装备股份有限公...	江苏振江新能源装备股份有限公司investRecordData_entName	上海底特精密紧固件股份有限公司	江苏振江新能源装备股份有限公司(以下简称公司) 与切斯特技术公
7月6日,清洁能源供热供冷技术与产业交流会在青岛召开,青岛科创蓝新能源股份有限公司研制出的污水及地表水单宽流道式换热器和疏导管式换热设备,或将取代传统的燃煤供热。 污水及地表水单宽流道式换热器和疏导管式换热设备的传热系数高于150...	青岛科创蓝新能源股份有限公司holdsData_logoWord	科创蓝	科创蓝新能源股份有限公司研制出的污水及地表水单宽流道式换热器和疏
电力扶贫光耀中原——国网河南省电力公司助推全省脱贫攻坚纪实	国网河南省电力公司holdsData_logoWord	国网河南	国网河南省电力公司助推全省脱贫攻坚😎
云南网讯(通讯员杨爱梅)10月24日,在庄严的国歌声中,中国共产党云南电网有限责任公司德宏供电局第一次代表大会隆重召开。 德宏供电局党委书记、局长刘正雷作了题为落实从严治党责任发挥核心引领作用奋力谱写德宏供电局高质量发展新篇章的...	云南电网有限责任公司holdsData_logoWord	供电	德宏供电局第一次代表大会隆重召开。, 德宏供电局党委书记, 局长刘正
广东华锋新能源科技股份有限公司                  (独立董事 周乔) 各位股东及股东代表:	广东华锋新能源科技股份有限公司directorsData_title	董事	董事周乔) , 各位股东及股东代表:
深圳市拓日新能源科技股份有限公司(以下简称“公司”)第四届董事会第十七次会议于2017年9月28日在深圳市南山区侨香路香年广场A栋803会议室以现场与通讯方式召开,会议通知于2017年9月21日以书面及电话方式通知全体董事、监事和高级管理...	深圳市拓日新能源科技股份有限公司directorsData_title	董事	董事会第十七次会议于2017年9月28日在深圳市南山区侨香路香年广场a栋
郑州宇通客车股份有限公司关于独立董事公开征集投票权的公告	郑州宇通客车股份有限公司directorsData_title	董事	董事公开征集投票权的公告😎
【招聘】国网河南省电力公司计划招聘330人!报名方式看这里!	国网河南省电力公司holdsData_logoWord	国网河南	国网河南省电力公司计划招聘330人! 报名方式看这里! 😎😎😎😎
早报讯 刚宣布要进军超级电动跑车领域的比亚迪股份有限公司(比亚迪,002594.SZ;01211.HK)13日晚间公告称,创办人之一的夏佐全减持600万股A股,占比亚迪总股本的0.26%,套现金额达2.3334亿元。	比亚迪股份有限公司logoWord	比亚迪	比亚迪股份有限公司(比亚迪, 002594. sz; 01211. hk) 13日晚间公告
1、交易标的:中润油新能源股份有限公司(以下简称“标的公司”或“中 润油”)股权。 2、交易事项:本公司与标的公司控股股东中润环能和股东及实际控制人王 菊林签订《股份认购及增资协议》和《股份认购及增资补充协议》,认购中润油...	中润油新能源股份有限公司investRecordData_logoWord	中润油	中润环能和股东及实际控制人王, 菊林签订《股份认购及增资协议》和《
董明珠从银隆新能源股份有限公司股东中退出	银隆新能源股份有限公司shareholdersData_name	董明珠	董明珠从银隆新能源股份有限公司股东中退出😎
联晟公司作为江苏鼎胜新能源材料股份有限公司,杭州鼎福铝业有限公司、杭州五星铝业有限公司的铝箔毛料供应商,根据客户需求生产出相应规格的铝箔毛料,其中包括高精度铝箔毛料双/单零箔基材、空调箔坯料等,这些产品会运往合作公司进行后续轧制,...	江苏鼎胜新能源材料股份有限公司investRecordData_entName	杭州五星铝业有限公司	杭州鼎福铝业有限公司, 杭州五星铝业有限公司的铝箔毛料供应商, 根据
截至目前为止,望靖东已经在格力电器工作了将近18年,是担任重要职位12年的老将,在2019年1月的格力电器股东大会上,望靖东还被推选为格力电器非独立董事。公开资料显示,珠海格力电器股份有限公司(简称:格力电器)成立于1989年,1996年11月在深...	珠海格力电器股份有限公司holdsData_logoWord	格力电器	格力电器股份有限公司(简称: 格力电器) 成立于1989年, 1996年11月在深.
本公司及董事会全体成员保证信息披露内容的真实、准确和完整,没有虚假记载、误导性陈述或重大遗漏。 重要内容提示: ● 2021年4月26日,中国广核电力股份有限公司(以下简称“公司”、“本公司”)控股股东中国广核集团有限公司(以下简称“中...	中国广核集团有限公司directorsData_title	董事	董事会全体成员保证信息披露内容的真实, 准确和完整, 没有虚假记载,
本公司及董事会全体成员保证信息披露的内容真实、准确、完整,没有虚假记载、误导性陈述或重大遗漏。 一、股东大会审议通过利润分配情况 1、大族激光科技产业集团股份有限公司(以下简称“公司”)2020年年度权益分派方案已获2021年4月28日召开...	大族激光科技产业集团股份有限公司holdsData_logoWord	大族激光	大族激光科技产业集团股份有限公司(以下简称公司) 2020年年度权益
很高兴参加山东力诺瑞特新能源有限公司国家住宅产业化基地授牌仪式,首先我代表建设部,对山东力诺瑞特新能源有限公司列入国家住宅产业化基地表示祝贺!借此机会,讲三点意见。 第一,充分认识创建国家住宅产业化基地的重要意义 ...	山东力诺瑞特新能源有限公司investRecordData_logoWord	力诺瑞特	力诺瑞特新能源有限公司国家住宅产业化基地授牌仪式, 首先我代表建设
[公告]金 飞达:南京奥特佳新能源科技有限公司审计报告及财务报表...	南京奥特佳新能源科技有限公司shareholdersData_logoWord	奥特佳	奥特佳新能源科技有限公司审计报告及财务报表. . .
王新奇 生前为商水县平店乡刘大庄村第一书记、国网河南省电力公司商水县供电公司发展建设部主管 徐林刚 国家开发银行河南省分行资深经理 湖北省 刘志耀 武汉市江夏区舒安街八秀村驻村工作队队长兼第一书记,舒安街党工委副书记(挂职)...	国网河南省电力公司logoWord	国网河	国网河南省电力公司商水县供电公司发展建设部主管, 徐林刚, 国家开发
温馨提醒:2014年广东年度经济风云榜颁奖典礼将于2015年1月11日22:15在广东广播电视台卫星频道播出,敬请关注! 附:2014广东年度经济风云榜十大风云企业名单 广东纽恩泰新能源科技发展有限公司 广州赛莱拉干细胞科技股份有限公司 广东新邦物流有...	广东纽恩泰新能源科技发展有限公司logoWord	纽恩泰	纽恩泰新能源科技发展有限公司, 广州赛莱拉干细胞科技股份有限公司,
股票代码:600617 900913 股票简称:国新能源 国新B股 编号:2016-016 山西省国新能源股份有限公司关于全资 子公司山西天然气有限公司与关联方 签订采购合同暨关联交易的公告 本公司董事会及全体董事保证本公告内容不存在任何虚假记载,误导性...	山西省国新能源股份有限公司directorsData_title	董事	董事会及全体董事保证本公告内容不存在任何虚假记载, 误导性. . .
湖南高创新能源有限公司副总经理夏亮一行到访湖南省可再生能源学会	湖南高创新能源有限公司directorsData_title	副总经理	经理夏亮一行到访湖南省可再生能源学会😎😎
长城汽车:长城汽车股份有限公司关于2020年限制性股票与股票期权激励计划首次授予限制性股票第一期解锁暨上市公告	长城汽车股份有限公司investRecordData_logoWord	长城汽车	长城汽车股份有限公司关于2020年限制性股票与股票期权激励计划首次授予
仁怀中电环保发电有限公司招聘公告 仁怀中电环保发电有限公司于2014年7月注册成立,注册资金为2亿元人民币,是中电国际新能源控股有限公司全资子公司。项目地址位于贵州省仁怀市,主要开展遵义市及仁怀市生活垃圾焚烧发电项目建设及运营,项目总投...	中电国际新能源控股有限公司holdsData_logoWord	中电环保	中电环保发电有限公司招聘公告, 仁怀中电环保发电有限公司于2014年7月
法定代表人为董明珠，注册资本5000万人民币。经营范围包括许可项目：第三类医疗器械经营；第二类医疗器械生产；第三类医疗器械生产；消毒器械生产；消毒器械销售等。天眼查App股东信息显示，该公司由珠海格力电器股份有限公司100%持股。	珠海格力电器股份有限公司legalPerson	董明珠	董明珠, 注册资本5000万人民币。经营范围包括许可项目：第三类医疗器械
2017年4月26日,由第三代半导体产业技术创新战略联盟主办,北京华商三优新能源科技有限公司、泰科天润半导体科技(北京)有限公司承办的“碳化硅新型充电桩示范工程启动暨技术与应用研讨会”在北京格兰云天国际酒店成功召开。会上,正式启动了我国首...	北京华商三优新能源科技有限公司logoWord	华商三优	华商三优新能源科技有限公司, 泰科天润半导体科技(北京) 有限公司承
2018年11月13日，已经更名为“银隆新能源股份有限公司”的珠海银隆通过官微发出《致银隆新能源股份有限公司各股东的函》，称银隆原董事长魏银仓、原总裁孙国华涉嫌通过关联交易侵占公司利益，涉及金额超过10亿元，目前公司已经向珠海市中级...	银隆新能源股份有限公司directorsData_title	董事长	董事长魏银仓, 原总裁孙国华涉嫌通过关联交易侵占公司利益, 涉及金额
【东风公司领导班子成员调整:陈昊任副总经理、党委常委】12月29日,东风汽车集团有限公司对外发布消息称,陈昊任东风汽车集团有限公司副总经理、党委常委。当日,东风公司召开领导班子(扩大)会。受中组部委托,东风公司董事长、党委书记竺延风宣布...	东风汽车集团有限公司directorsData_name	竺延风	竺延风宣布. . . 😎
全国人大代表、湖南科力远新能源股份有限公司董事长钟发平简历	湖南科力远新能源股份有限公司shareholdersData_name	钟发平	钟发平简历😎😎😎
原标题:20延长01 : 陕西延长石油(集团)有限责任公司公司债券2020年跟踪评级报告经营带来一定不利影响。2. 公司 债务负担较重,短期债务占比上升。 2019 年,公 司有息债务规模继续增长,若将可 续期债券计入公司债务,公司债务负担较重且...	陕西延长石油(集团)有限责任公司holdsData_logoWord	石油	石油(集团) 有限责任公司公司债券2020年跟踪评级报告经营带来一定不利
王友友 青海嘉恒汽车销售有限公司售后维修车间中级机修技师 宋建鹏 青海中利光纤技术有限公司助理工程师 孙啟宗 阳光能源(青海)有限公司原料、后道车间职工 王珑 青海绿草地新能源科技有限公司董事长、工程师 陈顺水 青海时代新能源科技...	青海绿草地新能源科技有限公司logoWord	绿草地	绿草地新能源科技有限公司董事长, 工程师, 陈顺水, 青海时代新能源科
大众汽车会不会太过自信? 创维集团“造车”?只是一场改名游戏 4月27日,开沃新能源汽车集团对外发布“创维汽车”品牌,开沃新能源汽车集团股份有限公司董事长、创维创始人黄宏生表示,“未来十年,创维会进入全球电动车领域第一阵营。”当天...	开沃新能源汽车集团股份有限公司directorsData_title	董事长	董事长, 创维创始人黄宏生表示, 未来十年, 创维会进入全球电动车领
日前,网通社从上海联合产权交易所获悉,一汽吉林汽车有限公司增资项目落定,山东宝雅新能源汽车股份有限公司投资15亿元,获得一汽吉林70.5%的股权。 一汽吉林此前在上海产权交易所挂牌交易,为募集15亿元资金拟转让70%股权。在多家投资者竞标中...	山东宝雅新能源汽车股份有限公司investRecordData_logoWord	一汽吉林	一汽吉林汽车有限公司增资项目落定, 山东宝雅新能源汽车股份有限公司
的《中国广核集团有限公司董事长和 董事发生变动的公告》,根据公司股东决议,聘任杨长利担任公司 董 事长,贺禹不再担任公 司董事长、董事 ; 聘任李定成、马力、徐海和担任公司 董事,沙鸣、高名湘不再担任公司董 事。截至...	中国广核集团有限公司directorsData_title	董事	董事长和, 董事发生变动的公告》, 根据公司股东决议, 聘任杨长利担任
湖南红太阳:2月4日,湖南省发改委公示了湖南红太阳新能源科技有限公司300MW光伏组件大尺寸高功率生产线系统集成项目备案信息。备案信息显示,湖南红太阳将投资12000万元在湖南省长沙市天心区新开铺路105号新建一条300MW光伏组件大尺寸高功率...	湖南红太阳新能源科技有限公司logoWord	红太阳	红太阳新能源科技有限公司300mw光伏组件大尺寸高功率生产线系统集成项
随后,郑州市政府与国网河南省电力公司签署“十四五”电网发展合作框架协议。 国网河南省电力公司总经理、党委副书记王刚,市领导侯红、牛卫国、吴福民、史占勇、陈宏伟、杨东方等参加活动。	国网河南省电力公司logoWord	国网河	国网河南省电力公司总经理, 党委副书记王刚, 市领导侯红, 牛卫国, 吴
据悉,深圳威迈斯新能源股份有限公司是一家聚焦新能源汽车核心零部件开发的高新技术企业,主要业务领域包括汽车、通信、医疗、电梯,其中新能源汽车业务占比85%以上,国内主流的主机厂如上汽乘用车、上海通用、广汽、吉利、奇瑞、长安、理想、小...	深圳威迈斯新能源股份有限公司holdsData_logoWord	威迈斯	威迈斯新能源股份有限公司是一家聚焦新能源汽车核心零部件开发的高新
孙宏兵任云南电网有限责任公司董事、总会计师。 江北任云南电网有限责任公司董事、副总经理、党委委员。 徐尤峰 任云南电网有限责任公司副总经理,免去其云南电网有限责任公司昆明供电局局长、党委副书记、委员职务。	云南电网有限责任公司holdsData_logoWord	供电	供电局局长, 党委副书记, 委员职务。
浙江正泰新能源开发有限公司作为中国光伏行业协会副理事长单位受邀出席。9日下午，由工信部、国家能源局等六部委主办的智能光伏产业发展交流会召开，正泰新能源总裁陆川受邀出席并作为智能光伏试点示范企业分享经验及成果。在正泰集团“一云两...	浙江正泰新能源开发有限公司legalPerson	陆川	陆川受邀出席并作为智能光伏试点示范企业分享经验及成果。在正泰集团
股票代码:600617 900913 股票简称:国新能源 国新 B 股 编号:2017-008 山西省国新能源股份有限公司 关于下属公司为山西煤层气(天然气)集输有限公司 提供担保的公告 本公司董事会及全体董事保证本公告内容不存在任何虚假记载、误导性陈述...	山西省国新能源股份有限公司logoWord	国新能源	国新能源股份有限公司, 关于下属公司为山西煤层气(天然气) 集输有限
股票代码:600617 900913 股票简称:国新能源国新B股编号:2016-043 山西省国新能源股份有限公司关于全资子公司山西天然气有限公司 为山西临县国新燃气有限公司提供担保的公告 本公司董事会及全体董事保证本公告内容不存在任何虚假记载、误导性...	山西省国新能源股份有限公司holdsData_entName	山西天然气有限公司	山西天然气有限公司, 为山西临县国新燃气有限公司提供担保的公告, 本
南方网讯:4月27日下午,由广东省信用协会主办的诚信建设万里行信用大讲堂走进中国五百强企业——比亚迪股份有限公司。协会常务副会长兼秘书长张红丽,比亚迪股份有限公司轨道业务大湾区总监李江涛,广东汀大生物科技有限公司董事长何志明、广东汇佳...	比亚迪股份有限公司directorsData_title	董事长	董事长何志明, 广东汇佳. . . 😎
「简讯」中国广核集团有限公司取消发行17中广核SCP001 同花顺财经讯　中国广核集团有限公司称，鉴于近期市场的变化，本公司拟取消本期超短期融资券发行，调整后的发行安排另行公告。本次取消发行债券名称为17中广核SCP001。来源: 同花顺金融...	中国广核集团有限公司holdsData_logoWord	中广核	中广核scp001。来源: , 同花顺金融. . .
；2019年增选为中国汽车工程学会会士；曾任武汉9502客车厂助理工程师，北京理工大学讲师、副教授，现任广东华锋新能源科技股份有限公司董事长兼总经理，广东北理华创新能源汽车技术有限公司董事长，北京理工华创电动车技术有限公司董事长，...	广东华锋新能源科技股份有限公司directorsData_title	董事	董事长兼总经理, 广东北理华创新能源汽车技术有限公司董事长, 北京理
广东华锋新能源科技股份有限公司(以下简称“公司”)第四届董事会第二十六次会议于2018年12月9日以书面、电话、电子邮件等形式发出通知,并于2018年12月19日以通讯表决方式召开。本次会议应参加董事12名,实际参加董事12名。会议由董事长...	广东华锋新能源科技股份有限公司directorsData_title	董事长	董事长. . .
中国广核集团有限公司党委书记、董事长贺禹:全面建设世界一流清洁...	中国广核集团有限公司directorsData_title	董事长	董事长贺禹: 全面建设世界一流清洁. . . 😎
证券代码:300116 股票简称:保力新公告编号:2020-145 保力新能源科技股份有限公司 关于对外投资设立三门峡百姓新能源汽车投资合伙企业(有限合 伙)的公告 本公司及董事会全体成员保证公告内容真实、准确和完整,没有虚假性记载、误 ...	保力新能源科技股份有限公司holdsData_logoWord	保力新	保力新能源科技股份有限公司, 关于对外投资设立三门峡百姓新能源汽车
[2017]46号),湖南科力远新能源股份有限公司全资子公司湖南科霸汽车动力电池有限责任公司的“年产5.18亿安时车用动力电池产业化项目——节能与新能源汽车动力电池智能工厂”项目获得额度为1200万元的智能制造综合标准化与新模式应用补助项目...	湖南科力远新能源股份有限公司investRecordData_logoWord	科力远	科霸汽车动力电池有限责任公司的年产5.18亿安时车用动力电池产业
东风汽车集团有限公司总经理李绍烛:助推武汉汽车产业转型升级	东风汽车集团有限公司directorsData_name	李绍烛	李绍烛: 助推武汉汽车产业转型升级😎
近日,康佳集团股份有限公司(下称“本公司”)与滁州皖东农村商业银行城中支行(简称“皖东商业银行城中支行”)签署了《保证合同》。根据合同约定,本公司为皖东商业银行城中支行与本公司全资子公司安徽康佳同创电器有限公司(下称“康佳同创...	康佳集团股份有限公司logoWord	康佳	康佳集团股份有限公司(下称本公司) 与滁州皖东农村商业银行城中
潍柴动力：潍柴动力股份有限公司独立董事关于公司是否存在同业竞争和避免同业竞争措施的有效性的独立意见 【来源：中国证监会】声明：转载此文是出于传递更多信息之目的。若有来源标注错误或侵犯了您的合法权益，请作者持权属证明与本网联系，...	潍柴动力股份有限公司investRecordData_logoWord	潍柴动力	潍柴动力股份有限公司独立董事关于公司是否存在同业竞争和避免同业竞
中国经济周刊-经济网讯 天眼查APP显示，近日，珠海格力电器股份有限公司新增多项专利信息，其中包括“驱动制动装置及具有其的汽车”，“电源控制电路及电动汽车”，二者的公开日期均为2020年9月1日，专利类型均为实用新型。其中，“电源控制...	珠海格力电器股份有限公司logoWord	格力电器	格力电器股份有限公司新增多项专利信息, 其中包括驱动制动装置及具
12月26日上午,由东风延锋武汉、十堰两家公司组建而成新的东风延锋汽车饰件系统有限公司在武汉隆重举行揭牌仪式。武汉市委常委、武汉开发区工委书记胡洪春到场表示祝贺,东风汽车有限公司执行副总裁周先鹏、党委书记赵书良;东风有限副总裁、东风...	东风汽车有限公司investRecordData_logoWord	东风汽车	汽车饰件系统有限公司在武汉隆重举行揭牌仪式。武汉市委常委, 武汉开
本公司及董事会全体成员保证信息披露的内容真实、准确、完整,没有虚假记载、误导性陈述或重大遗漏。 潍柴动力股份有限公司(下称“公司”或“潍柴动力”)2021年第一次临时董事会会议(下称“本次会议”)通知于2021年2月22日以专人送达或...	潍柴动力股份有限公司investRecordData_logoWord	潍柴动力	潍柴动力股份有限公司(下称公司或潍柴动力) 2021年第一次临时
本公司于3月11日与中国银行南京江宁经济开发区支行签署了担保协议,为全资子公司南京奥特佳新能源科技有限公司(以下简称南京奥特佳)向该行申请8000万元贷款提供最高额保证担保额度,担保期限自2021年3月11日至2022年3月10日,担保方式为连带...	南京奥特佳新能源科技有限公司logoWord	奥特佳	奥特佳新能源科技有限公司(以下简称南京奥特佳) 向该行申请8000万元贷
最终C标段由原平市远方商贸有限公司竞买成功,成交数量5000吨,成交价格570元/吨。 请山西沁新能源集团股份有限公司和原平市远方商贸有限公司,按照《中国太原煤炭交易中心有限公司关于山西沁新能源集团…	山西沁新能源集团股份有限公司logoWord	沁新能源	沁新能源集团股份有限公司和原平市远方商贸有限公司, 按照《中国太原
近日,公司副总经理张利一行赴青岛科创蓝新能源股份有限公司进行洽谈交流。青岛科创蓝新能源股份有限公司董事长迟芳等人出席了会谈。 会谈中,双方就组建魏县清洁能源供热项目SPV公司进行了协商,决定分别成立协调小组,制定联系机制,明确责任分工和...	青岛科创蓝新能源股份有限公司holdsData_logoWord	科创蓝	科创蓝新能源股份有限公司董事长迟芳等人出席了会谈。, 会谈中, 双方
如果未按本判决指定的期间的履行给付金钱义务,应当依照《中华人民共和国民事诉讼法》第二百五十三条规定,加倍支付迟延期间的债务利息。 案件受理费213430元,财产保全费5000元,由被告保定天威英利新能源有限公司负担。	保定天威英利新能源有限公司shareholdersData_logoWord	天威	天威英利新能源有限公司负担。
3月18日,中国光伏行业协会第三次会员大会&第三届理事会第一次会议在安徽合肥顺利召开。会议通过投票,选举产生协会第三届理事长、副理事长、秘书长等。浙江正泰新能源开发有限公司董事长兼总裁陆川等16位企事业单位代表当选中国光伏行业协...	浙江正泰新能源开发有限公司legalPerson	陆川	陆川等16位企事业单位代表当选中国光伏行业协. . .
公开资料显示，乔阳曾任东风汽车公司财务会计部部长助理、副部长，东风汽车公司计划财务部副部长兼东风汽车公司副总会计师，东风汽车有限公司财务会计总部总部长、党委书记等职务。冯长军曾在中国兵器装备集团公司担任财务与审计部预算处副处长...	东风汽车有限公司logoWord	汽车	汽车有限公司财务会计总部总部长, 党委书记等职务。冯长军曾在中国兵
4月26日,中信国安信息产业股份有限公司发布公告,确认一项资产出售已经完成。 据悉,在2020年7月,中信国安董事会通过议案决定向荣盛控股股份有限公司转让参股公司荣盛盟固利新能源科技有限公司22.61%股权。 该项转让价格以荣盛盟固利截至2020...	荣盛盟固利新能源科技有限公司shareholdersData_subRate	1%	22.61% 股权。, 该项转让价格以荣盛盟固利截至2020. . .
签订《关于苏州捷力新能源材料有限公司之股权转让框架协议》的公告 本公司及全体董事保证本公告内容真实、准确和完整,没有虚假记载、 误导性陈述或者重大遗漏。 重要提示: 1、本次云南恩捷新材料股份有限公司(以下简称“公司”或“云南恩...	苏州捷力新能源材料有限公司directorsData_title	董事	董事保证本公告内容真实, 准确和完整, 没有虚假记载, , 误导性陈述或
中国三峡新能源(集团)股份有限公司创立大会、第一届董事会第一次会议、第一届监事会第一次会议周三在北京召开。经全体发起人中国长江三峡集团有限公司、都城伟业集团有限公司、中国水利水电建设工程咨询有限公司、三峡资本控股有限责任公司、...	中国三峡新能源(集团)股份有限公司shareholdersData_name	中国水利水电建设工程咨询有限公司	中国长江三峡集团有限公司, 都城伟业集团有限公司, 中国水利水电建设
6月23日晚间,特变电工(sh600089)发布公告称,为加快光伏资源的开发,公司控股公司特变电工新疆新能源股份有限公司设立了全资公司交口县光煜光伏发电有限责任公司,并以交口光煜公司为主体投资建设交口300MW光伏平价项目。	特变电工新疆新能源股份有限公司logoWord	特变电工	特变电工新疆新能源股份有限公司设立了全资公司交口县光煜光伏发电有
国网湖南省电力有限公司关于供应商不良行为处理情况的通报(2021年5月) 国网河北省电力有限公司关于供应商不良行为处理情况的通报(2021年5月) 国网四川省电力公司关于供应商不良行为处理情况的通报(2021年5月) ...	国网河北省电力有限公司investRecordData_logoWord	国网河	国网河北省电力有限公司关于供应商不良行为处理情况的通报(2021年5月
口述:长城汽车股份有限公司董事长 魏建军 新媒体编辑:胸怀天下 长城汽车董事长魏建军:做产品,要学会“优生优育”.mp3来自中外管理00:0008:41 《中外管理》曾经介绍过我们长城做“冷门”产品的经验。的确,正是抓住了大行业中的小市场,长...	长城汽车股份有限公司investRecordData_logoWord	长城汽车	长城汽车股份有限公司董事长, 魏建军, 新媒体编辑: 胸怀天下, 长城汽
从东风汽车有限公司官微获悉,4月29日,东风汽车有限公司宣布公司管理层人事调整,以进一步强化东风有限领导团队,推进东风有限事业计划的实施。日产汽车公司特殊项目企业副总裁山口武先生将担任东风汽车有限公司副总裁、东风日产乘用车公司总经理,...	东风汽车有限公司logoWord	汽车	汽车有限公司副总裁, 东风日产乘用车公司总经理, . . . 😎😎😎😎😎😎
国电电力内蒙古新能源开发有限公司成立于2009年12月，现有正式员工121人，公司全面负责国电电力在内蒙古地区风电、太阳能等新能源项目的开发、建设及生产运营。国电电力内蒙古新能源开发有限公司不断完善领导体系，统筹开展文明诚信企业创建工作...	国电电力内蒙古新能源开发有限公司logoWord	国电电	国电电力内蒙古新能源开发有限公司成立于2009年12月, 现有正式员工121人
12月21日,申能股份发布公告称,公司全资子公司申能新能源(青海)有限公司(以下简称“申能青海”)受让特变电工新疆新能源股份有限公司(以下简称“特变新疆”)拥有100%股权的六个风电和光伏电站项目,总装机容量为17.95万千瓦。其中风电4....	特变电工新疆新能源股份有限公司logoWord	特变电工	特变电工新疆新能源股份有限公司(以下简称特变新疆) 拥有100% 股
8月9日，贵阳市委副书记、市长，贵安新区党工委副书记、管委会主任陈晏陪同珠海格力电器股份有限公司董事长董明珠一行在贵阳考察，强调要深化合作交流、携手共赢发展，助力贵阳贵安构建经济体量大能级城市。贵阳市委常委、常务副市长徐昊，市...	珠海格力电器股份有限公司legalPerson	董明珠	董明珠一行在贵阳考察😎
日前,中核山东能源贵州六枝特区大用现代农业光伏发电项目组件设备国内公开招标中标候选人公示,湖南红太阳新能源科技有限公司以1.44元/瓦的单价中标,组件规格为单晶405W。 根据招标公告,贵州六枝特区大用现代农业光伏电站位于贵州省六枝特区关...	湖南红太阳新能源科技有限公司logoWord	红太阳	红太阳新能源科技有限公司以1.44元/瓦的单价中标, 组件规格为单晶
山西省国新能源股份有限公司 关于选举职工监事的公告 本公司董事会及全体董事保证本公告内容不存在任何虚假记载、误导性陈述或者重大遗漏,并对其内容的真实性、准确性和完整性承担个别及连带责任。 根据《公司法》及《公司章程》等有关规定...	山西省国新能源股份有限公司directorsData_title	董事	董事会及全体董事保证本公告内容不存在任何虚假记载, 误导性陈述或者
每经AI快讯,捷佳伟创(SZ 300724,收盘价:102.61元)10月29日晚间发布公告称,深圳市捷佳伟创新能源装备股份有限公司近日接到公司控股股东、实际控制人余仲先生的通知,余仲于2020年10月28日质押67万股,占公司总股本比例为0.21%。	深圳市捷佳伟创新能源装备股份有限公司logoWord	捷佳伟创	捷佳伟创新能源装备股份有限公司近日接到公司控股股东, 实际控制人余
来源：澎湃新闻 原标题：杨青任东风汽车集团有限公司董事、总经理、党委副书记 微信公众号“东风汽车”2月25日消息，2021年2月25日下午，东风汽车集团有限公司召开领导班子（扩大）会议。受中央组织部领导委托，中央组织部有关干部局负责...	东风汽车集团有限公司directorsData_title	董事	董事, 总经理, 党委副书记, 微信公众号东风汽车2月25日消息,
根据深圳市科陆电子科技股份有限公司(以下简称“公司”)战略发展需要,公司第六届董事会第二十六次(临时)会议及2017年第六次临时股东大会审议通过了《关于拟签署投资意向协议暨关联交易的议案》,同意公司向上海卡耐新能源有限公司(以下简称...	上海卡耐新能源有限公司directorsData_title	董事	董事会第二十六次(临时) 会议及2017年第六次临时股东大会审议通过了《
公司独立董事对该事项发表了同意的独立意见,具体内容详见公司同日于上海证券交易所网站(www.sse.com.cn)披露的《江苏振江新能源装备股份有限公司独立董事关于第二届董事会第十九次会议相关事项的独立意见》。 本项议案尚需提交公司 2019 ...	江苏振江新能源装备股份有限公司holdsData_logoWord	振江新能	振江新能源装备股份有限公司独立董事关于第二届董事会第十九次会议相
春节将至,年味愈浓,2月4日-9日,共青团齐河县委联合县法院、县扶贫办、齐河特战救援队、齐河蓝天救援队、奇瑞新能源汽车股份有限公司齐河分公司、齐河农商银行、齐河县伊康斋食品厂、山东瀚海网络科技有限公司齐…	奇瑞新能源汽车股份有限公司branchsData_entName	奇瑞新能源汽车股份有限公司齐河分公司	齐河分公司, 齐河农商银行, 齐河县伊康斋食品厂, 山东瀚海网络科技有
陕西延长石油榆林煤化有限公司(简称“榆林煤化公司”)是陕西延长石油(集团)有限责任公司下属的一家集煤、油、化、电综合转化利用的大型能源化工企业,位于榆林市榆横工业园区。主要从事甲醇、醋酸、油品等煤化工产品的生产、加工和销售。	陕西延长石油(集团)有限责任公司holdsData_logoWord	石油	石油榆林煤化有限公司(简称榆林煤化公司) 是陕西延长石油(集团
12月27日下午消息,天眼查数据显示,比亚迪的运营主体比亚迪股份有限公司于近日成立三家全资子公司,分别为弗迪模具有限公司、弗迪科技有限公司、弗迪动力有限公司,注册资本为共计3亿人民币。 弗迪模具有限公司成立于2019年12月24日,注册资本为...	比亚迪股份有限公司holdsData_logoWord	弗迪科技	比亚迪股份有限公司于近日成立三家全资子公司, 分别为弗迪模具有限公
截至2019年3月4日,大族激光科技产业集团股份有限公司(以下简称“公司”)股票2019年累计涨幅为38.34%,同期上证综指累计涨幅为21.40%,深圳成指累计涨幅为29.62%。针对近期公司股票交易价格波动较大的情况,公司对有关事项进行了梳理,并...	大族激光科技产业集团股份有限公司holdsData_logoWord	大族激光	大族激光科技产业集团股份有限公司(以下简称公司😎😎
7月9日，法院经过利能源(中国)有限公司管理人的申请作出(2020)冀06破1-2号民事裁定书，对英利能源(中国)有限公司、保定天威英利新能源有限公司、海南英利新能源有限公司、天津英利新能源有限公司、衡水英利新能源有限公司、蠡县英利新能源...	保定天威英利新能源有限公司investRecordData_logoWord	天威英利	英利能源(中国) 有限公司, 保定天威英利新能源有限公司, 海南英利新
东方电气风电有限公司是中国东方电气集团旗下的风电产业一体化专业公司,坚持以技术创新推动产品升级和产业发展,在行业内率先推出4.5SMW系列陆上、7MW和10MW等级海上风力发电机组。中国三峡新能源(集团)股份有限公司为中国长江三峡集团有限公...	中国三峡新能源(集团)股份有限公司shareholdersData_logoWord	长江三峡	长江三峡集团有限公. . . 😎
座谈中,荣盛盟固利新能源科技有限公司董事长助理刘建红从发展历程概况、股权架构、技术及产品研发情况、市场开拓计划、产能规划、研发规划等方面详细介绍了公司的基本情况和发展战略。 孙波向荣盛盟固利公司介绍了阳西文化旅游资源、产业基础...	荣盛盟固利新能源科技有限公司directorsData_title	董事长	董事长助理刘建红从发展历程概况, 股权架构, 技术及产品研发情况, 市
蹇彪谢卫东共同会见华能新能源股份有限公司党委书记、董事长王力军	华能新能源股份有限公司directorsData_title	董事长	董事长王力军😎
特别提示:本公司及董事会全体成员保证公告内容的真实、准确和完整,没有虚假记载、误导性陈述或重大遗漏。 深圳市拓日新能源科技股份有限公司(以下简称“公司”)第二届董事会第二十三次会议于2012年4月16日在深圳市南山区香年广场A栋80...	深圳市拓日新能源科技股份有限公司directorsData_title	董事	董事会第二十三次会议于2012年4月16日在深圳市南山区香年广场a栋80.
清华新闻网11月18日电(通讯员李 飞)11月17日,陕西延长石油(集团)有限责任公司(以下简称“延长石油”)与清华大学战略合作协议签约仪式在华业大厦举行。陕西省人民政府副省长姜锋、清华大学副校长薛其坤、延长石油董事长贺久长等出席签约仪式...	陕西延长石油(集团)有限责任公司directorsData_title	董事长	董事长贺久长等出席签约仪式. . . 😎
对证监会认定的上市公司实际控制人身份，陈义龙予以否认。其申辩意见称，《告知书》认定的依据包括陈义龙为丰盈长江新能源投资有限公司（下称“丰盈长江”）的实际控制人，可以通过丰盈长江控制阳光凯迪集团，为阳光凯迪新能源集团有限公司（下...	阳光凯迪新能源集团有限公司logoWord	阳光凯迪	阳光凯迪新能源集团有限公司（下. . .
根据上述电芯型号，这批被召回的电动汽车，电芯供应商为中兴高能公司。天眼查资料显示，中兴高能为中兴通讯股份有限公司（000063.SZ，下称“中兴通讯”）100%控股子公司，经营范围包括锂离子电池及其他类型新能源电池的研发、生产、销售等...	中兴通讯股份有限公司holdsData_logoWord	中兴高能	中兴通讯股份有限公司（000063. sz, 下称中兴通讯）100% 控股子
三、招标内容:广汇能源股份有限公司下属公司(新疆广汇新能源有限公司、新疆广汇煤炭清洁炼化有限责任公司、新疆广汇陆友硫化工有限公司、新疆广汇液化天然气发展有限责任公司、伊吾广汇矿业有限公司、新疆广汇能源综合物流发展有限责任公司)2020年...	新疆广汇新能源有限公司shareholdersData_logoWord	广汇能源	广汇能源股份有限公司下属公司(新疆广汇新能源有限公司, 新疆广汇煤
王力军表示，华能新能源股份有限公司牢牢把握“低碳经济、绿色发展”方向，以“打造中国乃至世界一流新能源企业”为战略目标，弘扬“和谐、创新、追求卓越”的企业精神，着力奉献清洁能源，改善电源结构，履行社会责任。朝阳新能源资源丰富、...	华能新能源股份有限公司directorsData_name	王力军	王力军表示, 华能新能源股份有限公司牢牢把握低碳经济, 绿色发展
证券代码：002256 证券简称：*ST兆新 公告编号：2020-194 本公司及董事会全体成员保证信息披露内容的真实、准确和完整，没有虚假记载、误导性陈述或重大遗漏。深圳市兆新能源股份有限公司（以下简称“公司”或“被执行人”）于近日收到...	深圳市兆新能源股份有限公司directorsData_title	董事	董事会全体成员保证信息披露内容的真实, 准确和完整, 没有虚假记载,
东方日升新能源股份有限公司 苏州腾晖光伏技术有限公司 通威太阳能(成都)有限公司 天合光能有限公司 阳光电源股份有限公司 华为技术有限公司 特变电工新疆新能源股份有限公司 阿特斯阳光电力有限公司 中建材浚鑫科技有限公司 深圳市禾望科技有...	特变电工新疆新能源股份有限公司logoWord	特变电工	特变电工新疆新能源股份有限公司, 阿特斯阳光电力有限公司, 中建材浚
11月25日,市委书记党晓龙与全球能源互联网研究院董事长、党委书记滕乐天,国网河北省电力有限公司董事长、党委书记王昕伟举行工作座谈,双方就智能电网、第三代半导体材料碳化硅新型电力电子器件、清洁能源等领域合作进行深入交流。市长郭建英主持...	国网河北省电力有限公司directorsData_title	董事	董事长, 党委书记王昕伟举行工作座谈, 双方就智能电网, 第三代半导体
本公司及董事会全体成员保证信息披露的内容真实、准确、完整,没有虚假记载、误导性陈述或重大遗漏。 一、股东大会审议通过利润分配情况 1、大族激光科技产业集团股份有限公司(以下简称“公司”)2020年年度权益分派方案已获2021年4月28日召开...	大族激光科技产业集团股份有限公司directorsData_title	董事	董事会全体成员保证信息披露的内容真实, 准确, 完整, 没有虚假记载,
蹇彪谢卫东共同会见华能新能源股份有限公司党委书记、董事长王力军	华能新能源股份有限公司legalPerson	王力军	王力军😎
中国网科技1月20日讯 天眼查数据显示，近日，银隆新能源股份有限公司发生人事变动，6位董事退出，其中珠海格力电器股份有限公司董事长董明珠为其中之一。此外，还有监事、监事会主席等退出。据悉，银隆新能源股份有限公司成立于2009年12月，...	珠海格力电器股份有限公司directorsData_name	董明珠	董明珠为其中之一。此外, 还有监事, 监事会主席等退出。据悉, 银隆新
根据《通知书》，2020年7月9日，河北省保定市中级人民法院(“保定中院”)作出(2020)冀06破1-2号民事裁定书，裁定英利能源(中国)有限公司、保定天威英利新能源有限公司、海南英利新能源有限公司、天津英利新能源有限公司、衡水英利新能源...	保定天威英利新能源有限公司shareholdersData_logoWord	天威	英利能源(中国) 有限公司, 保定天威英利新能源有限公司, 海南英利新
8月8日,北京前锋电子股份有限公司发布公告称,公司中文名称拟由“北京前锋电子股份有限公司”变更为“北汽蓝谷新能源科技股份有限公司”。 记者了解到,前锋股份根据《公司法》、《上海证券交易所股票上市规则》等法律、法规以及《公司章程》...	北汽蓝谷新能源科技股份有限公司logoWord	北汽蓝谷	北汽蓝谷新能源科技股份有限公司。, 记者了解到, 前锋股份根据《公
此前,天眼查和启信宝的信息均显示,银隆新能源股份有限公司(下称“银隆新能源”)多位董事、监事退出,其中包括珠海格力电器股份有限公司董事长董明珠。目前,银隆新能源主要人员仅为卢春泉和赖信华,董事长由卢春泉、赖信华担任,同时,赖信华还担...	银隆新能源股份有限公司directorsData_name	董明珠	卢春泉和赖信华, 董事长由卢春泉, 赖信华担任, 同时, 赖信华还担. .
未来,企业将以“新的技术,推动技术创新”为原则,立足打造千亿锂电产业为平台,结合国家产业政策,加快电芯集成储能发展规模。有力推动信息化和工业化深度融合,促进工业结构整体优化升级。 青海绿草地新能源科技有限公司董事长王珑表示:”加快...	青海绿草地新能源科技有限公司shareholdersData_name	王珑	王珑表示: 加快. . .
据启信宝检测显示,近日,长城汽车股份有限公司(下称:长城汽车)发生了多项工商变更,其中包括,马力辉退出董事会,由乐英接任;其经营范围也新增“新能源汽车充电桩的销售、安装、售后服务;会议及展览服务;工位器具及包装物销售、租赁、维修、...	长城汽车股份有限公司directorsData_title	董事	董事会, 由乐英接任; 其经营范围也新增新能源汽车充电桩的销售, 安
1992年,研究生毕业的黄辉加入珠海格力电器股份有限公司,从2000年8月至2014年5月,担任公司副总裁,2014年6月至2017年8月,任公司常务副总裁,2017年8月至2021年2月任公司执行总裁;另外从2007年5月至2017年8月,黄辉还担任公司的总工程师...	珠海格力电器股份有限公司holdsData_logoWord	格力电器	格力电器股份有限公司, 从2000年8月至2014年5月, 担任公司副总裁, 2014年
毛伟明董事长赴国网河南电力调研 高擎精神火炬奋力向前践行公司战略奋勇争先 7月14日，国家电网有限公司董事长、党组书记毛伟明一行赴国网河南省电力公司调研，了解基层情况，慰问干部职工。毛伟明强调，要深入学习贯彻习近平总书记重要讲话和...	国网河南省电力公司shareholdersData_name	国家电网有限公司	国家电网有限公司董事长, 党组书记毛伟明一行赴国网河南省电力公司调
每经AI快讯,东方日升(SZ 300118,收盘价:12.66元)4月30日晚间发布公告称,东方日升新能源股份有限公司全资子公司东方日升(义乌)新能源有限公司于近日收到与资产相关的政府补助资金人民币2618.86万元。 2020年年报显示,东方日升的主营业务...	东方日升新能源股份有限公司holdsData_logoWord	东方日升	东方日升(义乌) 新能源有限公司于近日收到与资产相关的政府补助资金
本公司及董事会全体成员保证信息披露内容的真实、准确和完整,没有虚假记载、误导性陈述或重大遗漏。 深圳市兆新能源股份有限公司(以下简称“公司”)第五届董事会第四十九次会议于2021年5月9日10:00在深圳市罗湖区笋岗梨园路8号HALO广...	深圳市兆新能源股份有限公司directorsData_title	董事	董事会第四十九次会议于2021年5月9日10: 00在深圳市罗湖区笋岗梨园路
[摘要]全国人大代表、湖南科力远新能源股份有限公司董事长钟发平在接受记者采访时表示,中国的新能源汽车要发展得好,要实现弯道超车,新能源汽车财政补贴的发放最好是通过公开招标。 全国人大代表、湖南科力远新能源股份有限公司董事长钟发平在...	湖南科力远新能源股份有限公司holdsData_logoWord	科力远	科力远新能源股份有限公司董事长钟发平在接受记者采访时表示, 中国的
现为潍柴动力股份有限公司三高试验队队长,高级工程师。吕文芝是潍柴首批从事“三高”试验的科研人员,他不畏艰险、勇于创新、敢为人先,带领潍柴三高试验队建成全球规模最大、涵盖机型最多、试验环境最苛刻的发动机运行数据库,为中国内燃机...	潍柴动力股份有限公司holdsData_logoWord	潍柴动力	潍柴动力股份有限公司三高试验队队长, 高级工程师。吕文芝是潍柴首批
循着家乡的“呼唤”,杨德仁带领国内顶级团队入驻荣德,协助企业开展晶体品质和表面特能等硅材料前沿领域的科技研究。扬州荣德新能源科技有限公司副总经理吴正旗介绍,目前实验室的数据和客户端反映都在国际上是技术领先的,也解决了铸造单晶长期...	扬州荣德新能源科技有限公司directorsData_title	总经理	经理吴正旗介绍, 目前实验室的数据和客户端反映都在国际上是技术领先
据陕西省纪委监委消息：日前，经中共陕西省委批准，陕西省纪委监委对陕西延长石油(集团)有限责任公司原副总经理袁海科严重违纪违法问题进行了立案审查调查。经查，袁海科严重违反政治纪律，对抗组织审查，长期搞迷信活动；违反中央八项规定精神...	陕西延长石油(集团)有限责任公司holdsData_logoWord	石油	石油(集团) 有限责任公司原副总经理袁海科严重违纪违法问题进行了立
内容包括几个方面,科力远混合动力技术有限公司这个名字比较新一些,但是我们公司的一个合资方是吉利,我们原来叫做吉利电子传动有限公司,已经有十多年的历史。科力远混合动力有限公司是由湖南科力远新能源股份有限公司与吉利汽车合资而成立的,...	湖南科力远新能源股份有限公司investRecordData_logoWord	科力远	科力远混合动力技术有限公司这个名字比较新一些, 但是我们公司的一个
现任湘火炬汽车集团股份有限公司董事长、潍柴动力股份有限公司董事长兼首席执行官。 2、聂新勇,男,51 岁,研究生,曾任新疆跃进钢铁厂宣传干事,新疆农业大学讲师,乌鲁木齐将军制锁厂厂长,西安半坡文化有限公司董事长、总经理;北京总府置业...	潍柴动力股份有限公司holdsData_logoWord	潍柴动力	潍柴动力股份有限公司董事长兼首席执行官。, 2, 聂新勇, 男, 51, 岁
2019年陕西延长石油(集团)有限责任公司大连化物所西安洁净能源...	陕西延长石油(集团)有限责任公司holdsData_logoWord	石油	石油(集团) 有限责任公司大连化物所西安洁净能源. . . 😎
​保定市与国网河北省电力有限公司签署战略合作协议	国网河北省电力有限公司logoWord	国网河	国网河北省电力有限公司签署战略合作协议😎😎😎😎😎
11日,记者从济南热力公司获悉,济南热力与山东地矿新能源有限公司合作成立了山东德和地热开发有限公司,该公司将着力开发临港经济开发区地热田,临港经济开发区有望用上地热供暖。 据济南热力公司相关负责人介绍,济南热力公司已成功探索空气源、...	山东地矿新能源有限公司investRecordData_logoWord	德和地热	德和地热开发有限公司, 该公司将着力开发临港经济开发区地热田, 临港
9月3日,东风汽车发布消息称,经东风汽车集团有限公司党委研究决定,2020年9月,周先鹏任东风汽车集团有限公司总经理助理、陈昊任东风汽车集团有限公司总经理助理。 江淮与六安市合作将建自动变速箱基地 ...	东风汽车集团有限公司logoWord	汽车	汽车集团有限公司总经理助理。, 江淮😎😎😎😎😎😎😎😎😎😎😎😎😎😎😎
上海电巴新能源科技有限公司联席董事长、北京菲特奥新能源投资有限公司总经理石予友,资深专家兰志波等行业领导、企业负责人出席了以“换·领未来”为主题的高峰论坛,并发表主题演讲,对换电模式面向全国推广等纯电动汽车未来商业模式进行了...	上海电巴新能源科技有限公司directorsData_name	兰志波	石予友, 资深专家兰志波等行业领导, 企业负责人出席了以换·领未来
成立山东睿冠电能热力有限公司探索电能替代供热模式;与山东地矿新能源有限公司合资成立山东德和地热开发有限公司,利用济南市丰富的地热资源建设新能源供热项目;与中广核、烟台核电研发中心就利用核能开展供热签署战略合作协议……为了构建能源整理...	山东地矿新能源有限公司investRecordData_logoWord	德和地热	地矿新能源有限公司合资成立山东德和地热开发有限公司, 利用济南市丰
沁源县委统战部深入山西沁新能源集团股份有限公司调研	山西沁新能源集团股份有限公司logoWord	沁新能源	沁新能源集团股份有限公司调研😎😎
1,475,202,656.41 后附财务报表附注为财务报表的组成部分。 企业法定代表人: 主管会计工作负责人: 会计机构负责人: 南京奥特佳新能源科技有限公司 合并资产负债表 (除特别注明外,金额单位均为人民币元) ...	南京奥特佳新能源科技有限公司holdsData_logoWord	奥特佳	奥特佳新能源科技有限公司, 合并资产负债表, (除特别注明外, 金额单
近日,有业内人士告诉记者,协鑫前期扩张迅猛,现在已经开始对业务进行整合梳理。他提到的一个表现是,保利协鑫(苏州)新能源有限公司(简称“苏州协鑫”)就被划给江苏中能硅业科技发展有限公司(简称“中能硅业”)了。	保利协鑫(苏州)新能源有限公司shareholdersData_logoWord	中能硅业	保利协鑫(苏州) 新能源有限公司(简称苏州协鑫) 就被划给江苏中
【EV视界报道】2021年2月25日,东风汽车集团有限公司召开领导班子(扩大)会议。受中央组织部领导委托,中央组织部有关干部局负责同志宣布了中央关于东风汽车集团有限公司总经理任职的决定。杨青同志将担任东风汽车集团有限公司董事、总经理、党委...	东风汽车集团有限公司logoWord	汽车	汽车集团有限公司董事, 总经理, 党委. . . 😎😎😎😎😎😎😎😎😎😎😎😎
司(以下简称华风发电公司),并以该子公司为主体投资建设并运营崇仁50MW 风电项目。 (二)董事会审议情况 2016年8月17日,公司2016年第七次临时董事会会议审议通过了《公司控 股公司特变电工新疆新能源股份有限公司投资建设崇仁县相山镇50...	特变电工新疆新能源股份有限公司logoWord	特变电工	特变电工新疆新能源股份有限公司投资建设崇仁县相山镇50. . .
鉴于上述违规事实和情节,经本所纪律处分委员会审核通过,根据《股票上市规则》第17.3条和《上海证券交易所纪律处分和监管措施实施办法》的有关规定,本所做出如下纪律处分决定:对长城汽车股份有限公司时任董事兼副总经理胡克刚予以通报批评。	长城汽车股份有限公司directorsData_title	董事	董事兼副总经理胡克刚予以通报批评。
本公司及董事会全体成员保证信息披露的内容真实、准确、完整,没有虚假记载、误导性陈述或重大遗漏。比亚迪股份有限公司(以下简称“本公司”或“公司”)于近日收到公司持股5%以上的股东吕向阳先生函告,获悉其将所持有本公司的部分股份办理...	比亚迪股份有限公司logoWord	比亚迪	比亚迪股份有限公司(以下简称本公司或公司) 于近日收到公司
天眼查数据显示，近日，银隆新能源股份有限公司发生人事变动，6位董事退出，其中珠海格力电器股份有限公司董事长董明珠为其中之一。此外，还有监事、监事会主席等退出。天眼查数据显示，2019年11月，银隆新能源曾被列为被执行人，执行标的超...	珠海格力电器股份有限公司investRecordData_logoWord	格力电器	格力电器股份有限公司董事长董明珠为其中之一。此外, 还有监事, 监事
据了解,2014年2月,中兴通讯股份有限公司旗下从事智慧城市建设的全资子公司——中兴网信科技有限公司,就与合川区签订了投资额达20亿元的战略投资框架协议,要将合川全面打造成“智慧城市”。	中兴通讯股份有限公司holdsData_logoWord	中兴通讯	中兴通讯股份有限公司旗下从事智慧城市建设的全资子公司中兴网信
1月16日，在国网河南省电力公司第七届职工代表大会第六次会议暨2020年工作会议上，公司表彰了2019年度劳动模范、先进工作者、先进集体和工人先锋号。2019年，公司以习近平新时代中国特色社会主义思想为指导，坚决贯彻国家电网有限公司党组和...	国网河南省电力公司logoWord	国网河	国网河南省电力公司第七届职工代表大会第六次会议暨2020年工作会议上,
同日,中国裁判文书网还公布了中化二建集团、新疆广汇新能源有限公司(以下简称“广汇新能源”)、广汇能源申请实现担保物权案件特别程序民事裁定书,裁定查封、扣押、冻结被申请人广汇新能源、广汇能源价值179216085.67元的财产。	新疆广汇新能源有限公司shareholdersData_logoWord	广汇能源	中化二建集团, 新疆广汇新能源有限公司(以下简称广汇新能源) ,
3、公司本次签署的协议不构成关联交易，也不构成《上市公司重大资产重组管理办法》规定的重大资产重组。二、交易对手方介绍 （一）珠海格力电器股份有限公司 1、法定代表人：董明珠 2、注册资本： 601,573.0878万元人民币 3、注册地址：...	珠海格力电器股份有限公司logoWord	格力电器	格力电器股份有限公司, 1, 法定代表人：董明珠, 2, 注册资本：, 601
工商资料显示，截至目前阳光凯迪新能源集团有限公司的股权结构：工商资料显示，截至目前丰盈长江新能源投资有限公司的股权结构：未来命运：董事会管理层换来老熟人 *ST凯迪能重生？ 从近期*ST凯迪人事变动上看，陈义龙正在加强对公司董事会和...	阳光凯迪新能源集团有限公司shareholdersData_logoWord	丰盈长江	丰盈长江新能源投资有限公司的股权结构：未来命运：董事会管理层换来
西安华通新能源股份有限公司(以下简称“华通能源”)近期在证监会网站披露招股说明书,公司拟在上交所发行不超过8233.34万股,发行后总股本不超过32933.34万股,保荐机构为海通证券。华通能源称,公司属于资本密集型企业,各地燃气项目前期的城市...	西安华通新能源股份有限公司investRecordData_logoWord	华通能源	华通能源) 近期在证监会网站披露招股说明书, 公司拟在上交所发行不
专科及以上,国网河南省电力公司2020年高校毕业生招聘公告(第二批)	国网河南省电力公司holdsData_logoWord	国网河	国网河南省电力公司2020年高校毕业生招聘公告(第二批) 😎
10月27日上午,陕西延长石油(集团)有限责任公司2021届校园专场招聘会在西安石油大学鄠邑校区就业指导中心多功能厅举行。陕西延长石油(集团)有限责任公司人力资源部副部长王祎,延长石油集团旗下油田、炼化、油气勘探等业务板块的13家企业代表,...	陕西延长石油(集团)有限责任公司holdsData_logoWord	石油	石油(集团) 有限责任公司人力资源部副部长王祎, 延长石油集团旗下油
中国长江三峡集团有限公司旗下中国三峡新能源(集团)股份有限公司(以下简称 " 三峡新能源 ")获得首次公开发行股票(IPO)批文,上市正式进入鸣锣倒计时。接下来,三峡新能源及其主承销商将与上交所协商确定发行日程,并刊登招股文件。	中国三峡新能源(集团)股份有限公司shareholdersData_logoWord	长江三峡	中国长江三峡集团有限公司旗下中国三峡新能源(集团) 股份有限公司(
甲方:中国广核集团有限公司 乙方:中国广核电力股份有限公司 (二)服务范围 中广核下属金融服务提供方向本集团提供金融服务,主要包括但不限于吸收存款、发放贷款、委托贷款、综合常年财务顾问服务、专项财务顾问服务、结算服务、保险服务、融资租...	中国广核集团有限公司investRecordData_entName	中国广核电力股份有限公司	中国广核电力股份有限公司, (二) 服务范围, 中广核下属金融服务提供
国家电投集团东方新能源股份有限公司(以下简称“公司”)于2019年3月30日在中国证券报、证券时报、巨潮资讯网披露了《国家电投集团河北电力有限公司向国家电投集团东方新能源股份有限公司提供2019年度临时拆借资金的关联交易公告》(公告编码:...	国家电投集团东方新能源股份有限公司logoWord	国家电投	国家电投集团东方新能源股份有限公司(以下简称公司) 于2019年3月
《公司章程》”)的 规定,北京市通商律师事务所(以下简称“本所”)接受潍柴动力股份有限公司(以 下简称“公司”)的委托,指派律师出席公司于 2017 年 6 月 8 日召开的 2016 年度 股东周年大会、2017 年第一次 A 股股东会议和 ...	潍柴动力股份有限公司logoWord	潍柴动力	潍柴动力股份有限公司(以, 下简称公司) 的委托, 指派律师出席公
日前,空气能专业第一品牌企业——广东纽恩泰新能源科技发展有限公司在官方微信发起了“关注纽恩泰微信,送礼送折扣”的优惠活动。在2014年4月15日-5月15日期间,消费者进店关注纽恩泰微信号即可获赠精美小礼品一份...	广东纽恩泰新能源科技发展有限公司logoWord	纽恩泰	纽恩泰新能源科技发展有限公司在官方微信发起了关注纽恩泰微信, 送
天眼查数据显示，6月24日，银隆新能源股份有限公司发生工商变更，董明珠从股东中退出。资料显示，银隆新能源股份有限公司成立于2009年，总部位于珠海，注册资本约11亿，法定代表人为赖信华，是一家以锂电池产业为经营核心，集电动汽车动力总成...	银隆新能源股份有限公司directorsData_name	董明珠	董明珠从股东中退出。资料显示, 银隆新能源股份有限公司成立于2009年,
日产汽车公司特殊项目企业副总裁山口武（Takeshi Yamaguchi）先生将担任东风汽车有限公司副总裁、东风日产乘用车公司总经理，并向日产汽车公司高级副总裁、日产中国管理委员会主席山崎庄平（Shohei Yamazaki）先生汇报；现任东风汽车有限公司副总裁...	东风汽车有限公司shareholdersData_logoWord	汽车	汽车有限公司副总裁. . . 😎😎😎😎😎😎😎
广东华锋新能源科技股份有限公司股东减持计划完成情况的公告2020-08-18 来源: 作者:本公司股东肇庆市汇海技术咨询有限公司保证向本公司提供的信息内容真实、准确、完整,没有虚假记载、误导性陈述或重大遗漏。 本公司及董事会全体成员保证...	广东华锋新能源科技股份有限公司shareholdersData_logoWord	汇海技术	汇海技术咨询有限公司保证向本公司提供的信息内容真实, 准确, 完整,
成立大会审议通过了《激光应用分会工作条例》,选举大族激光科技产业集团股份有限公司、中国电子科技集团公司第十一研究所、中国科学院半导体研究所、清华大学精密仪器系、北京工业大学激光工程研究院、中国久远高新技术装备有限公司、武汉锐科光纤...	大族激光科技产业集团股份有限公司holdsData_logoWord	大族激光	大族激光科技产业集团股份有限公司, 中国电子科技集团公司第十一研究
关于陕西延长石油(集团)有限责任公司公开发行2018年公司债券(第...	陕西延长石油(集团)有限责任公司logoWord	石油	石油(集团) 有限责任公司公开发行2018年公司债券(第. . .
现任湘火炬汽车集团股份有限公司董事长、潍柴动力股份有限公司董事长兼首席执行官。 2、聂新勇,男,51 岁,研究生,曾任新疆跃进钢铁厂宣传干事,新疆农业大学讲师,乌鲁木齐将军制锁厂厂长,西安半坡文化有限公司董事长、总经理;北京总府置业...	潍柴动力股份有限公司directorsData_title	董事	董事长兼首席执行官。, 2, 聂新勇, 男, 51, 岁, 研究生, 曾任新疆跃
根据中联资产评估集团有限公司出具的《湖南科力远新能源股份有限公司拟发行股份购买科力远混合动力技术有限公司部分股权项目资产评估报告》(中联评报字[2018]第1727号),本次评估以 2018 年 6 月 30 日为评估基准日,对CHS公司100%的股东...	湖南科力远新能源股份有限公司investRecordData_regRate	100%	100% 的股东. . . 😎
易成新能(SZ300080)4月26日晚间发布公告称,河南易成新能源股份有限公司董事会于近日收到公司财务总监石涛先生的书面辞职报告,因工作调整,石涛先生申请辞去所担任的公司财务总监职务。辞职后,石涛先生将继续担任公司全资子公司河南中原金太阳...	河南易成新能源股份有限公司directorsData_title	董事	董事会于近日收到公司财务总监石涛先生的书面辞职报告, 因工作调整,
天眼查App显示,5月6日,格力电器(临沂)有限公司成立,法定代表人为庄培,注册资本2亿,经营范围包括家用电器销售;互联网销售;制冷、空调设备销售;制冷、空调设备制造等。股东信息显示,该公司由珠海格力电器股份有限公司全资持股。 举报/反馈 ...	珠海格力电器股份有限公司holdsData_logoWord	格力电器	格力电器(临沂) 有限公司成立, 法定代表人为庄培, 注册资本2亿, 经
中国广核集团有限公司党委书记、董事长、总经理 杨长利:把握数字...	中国广核集团有限公司directorsData_name	杨长利	杨长利: 把握数字. . . 😎
同花顺财经讯 陕西延长石油(集团)有限责任公司称,鉴于近期市场波动较大,本公司拟取消本期短期融资券发行,调整后的发行安排另行公告。如有新的进展,本公司将及时进行披露,提请投资者关注。本次取消发行债券名称为21陕延油CP001。	陕西延长石油(集团)有限责任公司logoWord	石油	石油(集团) 有限责任公司称, 鉴于近期市场波动较大, 本公司拟取消本
1、康佳集团股份有限公司(下称:“本公司”)2018年年度分红派息方案已获本公司于2019年5月13日召开的2018年年度股东大会审议通过,分配方案具体内容如下: 1、本公司此次委托中国结算深圳分…	康佳集团股份有限公司logoWord	康佳	康佳集团股份有限公司(下称: 本公司) 2018年年度分红派息方案已获
本公司及监事会全体成员保证公告内容的真实、准确和完整,没有虚假记载、误导性陈述或者重大遗漏。 国家电投集团东方新能源股份有限公司(以下简称“东方能源或公司”)第六届董事会第三十二次会议于2021年4月15日发出通知,于2021年4月25日...	国家电投集团东方新能源股份有限公司investRecordData_logoWord	东方能源	国家电投集团东方新能源股份有限公司(以下简称东方能源或公司)
比其他项目改造进度提前)。此外，对2020年尚未开展施工设计的老旧小区，对照清单及时进行实地勘察，确保项目早储备、早行动。(国网河南省电力公司 代小龙 王辉供稿)汤阴县供电员工在该县星阁路小区更换400伏低压电缆。佚名摄 ...	国网河南省电力公司holdsData_logoWord	国网河南	国网河南省电力公司, 代小龙, 王辉供稿) 汤阴县供电员工在该县星阁路
什么是光伏逆变器防孤岛保护? - 深圳古瑞瓦特新能源股份有限公司...	深圳古瑞瓦特新能源股份有限公司investRecordData_logoWord	古瑞瓦特	古瑞瓦特新能源股份有限公司. . .
付若琳女士:1970年出生,研究生学历。现任中国普天信息产业集团有限公司财务部总经理。曾任中国普天信息产业股份有限公司财务部总经理、普天新能源有限责任公司财务总监等职务。 证券代码:600776 900941 股票简称:东方通信 东信B股 编号:临2020...	普天新能源有限责任公司directorsData_name	付若琳	付若琳女士: 1970年出生, 研究生学历。现任中国普天信息产业集团有限公
4月25日，市委书记、市人大常委会主任蹇彪，市委副书记、市长谢卫东共同会见华能新能源股份有限公司党委书记、董事长王力军一行，双方就深入推进新能源项目建设进行沟通交流。市领导鲁珏、张秀军、孙永东参加。蹇彪代表市委、市政府对王力军一行...	华能新能源股份有限公司directorsData_title	董事	董事长王力军一行, 双方就深入推进新能源项目建设进行沟通交流。市领
市委常委、副市长杨赤卫,东风汽车集团有限公司调研组一行出席会议。 会议听取了东风集团的基本情况介绍,双方与会人员就相关事宜进行了交流座谈。 旺堆对周先鹏一行的到来表示热烈欢迎,并就林芝基本情况进行了简要介绍。他说,东风公司是中央...	东风汽车集团有限公司investRecordData_logoWord	汽车	汽车集团有限公司调研组一行出席会议。, 会议听取了东风集团的基本情
2009年5月至今任本公司副董事长兼总经理,兼任成都海得控制系统有限公司董事长、浙江海得新能源有限公司董事长、福建海得自动化控制系统有限公司董事长、上海海得自动化控制软件有限公司董事、海得电气科技有限公司董事、吉林海得新能源科技有限...	浙江海得新能源有限公司directorsData_title	董事	董事长兼总经理, 兼任成都海得控制系统有限公司董事长, 浙江海得新能
本公司及董事会全体成员保证信息披露的内容真实、准确、完整,没有虚假记载、误导性陈述或重大遗漏。比亚迪股份有限公司(以下简称“本公司”或“公司”)于近日收到公司持股5%以上的股东吕向阳先生函告,获悉其将所持有本公司的部分股份办理...	比亚迪股份有限公司investRecordData_logoWord	比亚迪	比亚迪股份有限公司(以下简称本公司或公司) 于近日收到公司
英利新能源此次每股美国存股凭证代表一股普通股,公司发行了二千九百多万股,高盛(亚洲)和UBS 担任主承销商。 英利新能源有限公司的运营子公司为保定天威英利新能源有限公司,其是集研发、生产、销售于一体的太阳能光伏产品专业制造商。	保定天威英利新能源有限公司shareholdersData_logoWord	天威	天威英利新能源有限公司, 其是集研发, 生产, 销售于一体的太阳能光伏
尤为值得一提的是,西林隆在中国任职期间创建了日产汽车在华第一家合资公司——东风汽车有限公司。东风汽车有限公司,旗下东风日产乘用车公司、东风英菲尼迪汽车有限公司分别负责日产品牌、英菲尼迪品牌和启辰品牌乘用车业务。西林隆亦在面向联盟...	东风汽车有限公司investRecordData_logoWord	英菲尼迪	英菲尼迪汽车有限公司分别负责日产品牌, 英菲尼迪品牌和启辰品牌乘用
他介绍,多氟多新能源科技有限公司(下称“多氟多新能源”)成立于2010年,主营汽车用动力锂离子电池、储能电池等,是奇瑞、东风、长城等中高端汽车制造厂的配套供应商,目前主要为奇瑞“小蚂蚁”提供软包电池产品。2015年到2018年,多氟多装机量...	多氟多新能源科技有限公司shareholdersData_logoWord	多氟多	多氟多新能源科技有限公司(下称多氟多新能源) 成立于2010年, 主营
而珠海格力电器股份有限公司(以下简称“格力电器”,000651.SZ)与珠海银隆新能源股份有限公司(以下简称“银隆新能源”)则更像是由董明珠连接的两座城,各自为政。 其中,董明珠是否连任格力电器董事长,历经近半年延期后,终于在近日翻开续篇...	银隆新能源股份有限公司directorsData_title	董事	董事长, 历经近半年延期后, 终于在近日翻开续篇. . . 😎
受中央组织部领导委托，中央组织部有关干部局负责同志宣布了中央关于东风汽车集团有限公司总经理任职的决定∶杨青同志任东风汽车集团有限公司董事、总经理、党委副书记，免去李绍烛同志的东风汽车集团有限公司董事、总经理、党委副书记职务。相关...	东风汽车集团有限公司investRecordData_logoWord	汽车	汽车集团有限公司董事, 总经理, 党委副书记职务。相关. . .
挖贝网 11月16日消息，近日宇通客车（600066）发公告称，根据经营需要，郑州宇通客车股份有限公司第十届董事会第四次会议聘任曹中彦为公司副总经理。曹中彦由公司董事长兼总经理汤玉祥提名，任期自董事会审议通过之日起，至本届董事会任期...	郑州宇通客车股份有限公司legalPerson	汤玉祥	汤玉祥提名, 任期自董事会审议通过之日起, 至本届董事会任期. . . 😎
1992年7月参加工作，历任东风汽车有限公司东风日产乘用车公司法规部部长、总经理办公室主任、市场营销总部经销商支持部部长，深圳市东风南方实业集团有限公司总经理，东风日产乘用车公司市场销售总部副总部长，东风日产乘用车公司副总经理，东风...	东风汽车有限公司shareholdersData_logoWord	汽车	汽车有限公司东风日产乘用车公司法规部部长, 总经理办公室主任, 市场
6月12日，东风汽车集团有限公司召开领导班子（扩大）会。受中组部委托，东风汽车集团有限公司董事长、党委书记竺延风同志宣布了中组部关于干部任职的决定：乔阳任东风汽车集团有限公司副总经理，不再担任东风汽车集团有限公司总会计师职务；...	东风汽车集团有限公司directorsData_title	董事长	董事长, 党委书记竺延风同志宣布了中组部关于干部任职的决定：乔阳任
省交通运输厅与中兴通讯股份有限公司座谈交流	中兴通讯股份有限公司holdsData_logoWord	中兴通讯	中兴通讯股份有限公司座谈交流😎
4月26日,东风公司召开领导班子(扩大)会。会议宣布,黄伟任东风汽车集团有限公司董事、党委副书记。相关任职按有关法律规定办理。 公开资料显示,黄伟自1989年参加工作以来,曾先后担任中国东方电气集团公司副总经理,国家核电技术公司副总经理,中...	东风汽车集团有限公司investRecordData_logoWord	汽车	汽车集团有限公司董事, 党委副书记。相关任职按有关法律规定办理。,
德州富路车业有限公司董事长陆付军代表山东小型电动车企业宣读自律宣言书。 会中,山东时风(集团)有限责任公司、山东唐骏欧铃汽车制造有限公司、山东宝雅新能源汽车股份有限公司、山东梅拉德能源科技有限公司、德州富路车业有限公司、山东顺达翰...	山东宝雅新能源汽车股份有限公司directorsData_title	董事长	董事长陆付军代表山东小型电动车企业宣读自律宣言书。, 会中, 山东时
(本页无正文,为《国家电投集团东方新能源股份有限公司独立董事关于公司第六届董事会 二十八次会议相关事项的事前认可意见》之签字页) 独立董事签字: 夏鹏谷大可 张鹏2020年9月30日 中财网	国家电投集团东方新能源股份有限公司investRecordData_logoWord	国家电投	国家电投集团东方新能源股份有限公司独立董事关于公司第六届董事会,
潍柴动力募资20亿用于燃料电池全产业链项目,4月23日晚间,潍柴动力发布公告称,收到中国证监会核发的《关于核准潍柴动力股份有限公司非公开发行股票的批复》,核准公司非公开发行不超过7.93亿股、募资不超过130亿元的定增方案。根据潍柴动力...	潍柴动力股份有限公司investRecordData_logoWord	潍柴动力	潍柴动力股份有限公司非公开发行股票的批复》, 核准公司非公开发行不
湖南日报11月19日讯(记者 冒蕞 刘笑雪)今天下午,省政府与珠海格力电器股份有限公司举行会谈。省委副书记、省长许达哲,珠海格力电器股份有限公司董事长、总裁董明珠出席会谈。  副省长陈飞、省政府秘书长王群出席会谈。  近年来,我省与格...	珠海格力电器股份有限公司directorsData_title	董事长	董事长, 总裁董明珠出席会谈。, , 副省长陈飞, 省政府秘书长王群出席
图/长江日报记者 李永刚 摄 今日,原东风汽车公司对外发布公告,公司已经更名为东风汽车集团有限公司,并且已于11月14日完成工商变更登记。 关于东风汽车公司 更名为东风汽车集团有限公司的公告	东风汽车集团有限公司investRecordData_logoWord	汽车	汽车集团有限公司的公告😎
昨日，我市与国网河南省电力公司签署“十四五”电网发展合作框架协议，进一步深化务实合作，共建坚强智能电网，为加快洛阳都市圈和现代化强市建设夯实电力保障。
签约仪式前，市委书记李亚会见了国网河南省电力公司董事长、党委书记王金行一行...	国网河南省电力公司holdsData_logoWord	国网河南	国网河南省电力公司董事长, 党委书记王金行一行. . . 😎😎😎😎😎
近日,国电电力内蒙古新能源开发有限公司杭锦旗特高压外送基地风电3号项目100MW风电工程项目开标,国电联合动力中标。 项目概况:项目立项依据《鄂尔多斯市能源局关于国电电力杭锦旗特高压外送基地风电3号项目100MW风电工程核准的批复》(鄂能...	国电电力内蒙古新能源开发有限公司logoWord	国电电	国电电力内蒙古新能源开发有限公司杭锦旗特高压外送基地风电3号项目
( 2018年09月17日 ) 沪价管〔2018〕35号 上海市物价局关于利用扩大跨省区电力交易规模等措施降低工商业单一制目录电价的通知 国网上海市电力公司: 根据《国家发展改革委关于利用扩大跨省区电力交易规模等措施降低一般工商业电价有关事...	国网上海市电力公司logoWord	国网上	国网上海市电力公司: , 根据《国家发展改革委关于利用扩大跨省区电力
根据上述电芯型号，这批被召回的电动汽车，电芯供应商为中兴高能公司。天眼查资料显示，中兴高能为中兴通讯股份有限公司（000063.SZ，下称“中兴通讯”）100%控股子公司，经营范围包括锂离子电池及其他类型新能源电池的研发、生产、销售等...	中兴通讯股份有限公司logoWord	中兴通讯	中兴通讯股份有限公司（000063. sz, 下称中兴通讯）100% 控股子
保定天威保变电气股份有限公司(以下简称“公司”或“本公司” ) 于2020年7月18日披露了《保定天威保变电气股份有限公司关于参 股公司保定天威英利新能源有限公司被裁定实质合并重整的公告》。	保定天威英利新能源有限公司investRecordData_logoWord	天威英利	天威保变电气股份有限公司(以下简称公司或本公司😎
市名雕装饰股份有限公司、深圳经济特区房地产(集团)股份有限公司、深圳市亚泰国际建设股份有限公司、深圳市高新投集团有限公司、纽斯葆广赛(广东)生物科技股份有限公司、奕东电子科技股份有限公司、深圳威迈斯新能源股份有限公司担任独立董事。	深圳威迈斯新能源股份有限公司directorsData_title	董事	董事。
21、投资活动产生的现金流量净额本期较上年同期增加13,443.07万元,增长91.11%,主要系上期公司支付收购普乐新能源(蚌埠)有限公司投资款所致。 22、筹资活动产生的现金流量净额本期较上年同期增加5,326.13万元,增长84.29%,主要系上期...	普乐新能源(蚌埠)有限公司shareholdersData_logoWord	投资	普乐新能源(蚌埠) 有限公司投资款所致。, 22, 筹资活动产生的现金流
关键词:潍柴动力优秀发明家孙少军 摘要:山东省知识产权局近日公布第四届“山东优秀发明家”名单,潍柴动力股份有限公司高级工程师、执行总裁孙少军榜上有名,被省政府记一等功奖励。 (责编:wanghe) 机经网微信号 机经网微博  欢迎投稿,...	潍柴动力股份有限公司logoWord	潍柴动力	潍柴动力股份有限公司高级工程师, 执行总裁孙少军榜上有名, 被省政府
新华财经|国网河南省电力公司六大措施应对“七下八上”主汛期	国网河南省电力公司investRecordData_logoWord	国网河南	国网河南省电力公司六大措施应对七下八上主汛期
5、主持人:执行董事孙少军先生 6、本次会议的召开符合《中华人民共和国公司法》、《深圳证券交易所股票上市规则》、《香港联合交易所有限公司证券上市规则》等有关法律、行政法规、部门规章及《潍柴动力股份有限公司章程》的相关规定,会议合...	潍柴动力股份有限公司investRecordData_logoWord	潍柴动力	潍柴动力股份有限公司章程》的相关规定, 会议合. . . 😎
《关于选举第五届董事会董事长的议案》,董事会同意选举王安乐为公司董事长,任期自本次董事会审议通过之日起至公司...2020年4月至今任中国平煤神马集团副总工程师、新能源新材料事业部部长、河南易成新能源股份有限公司党委书记、董事长...	河南易成新能源股份有限公司directorsData_title	董事	董事长的议案》, 董事会同意选举王安乐为公司董事长, 任期自本次董事
2020年12月22日,国家能源集团浙江电力有限公司副总经理任井利一行莅临东方日升新能源股份有限公司集团总部参观调研,并就十四五期间在光伏电站投资开发、储能、售电等领域进行深入的交流。东方日升总裁谢健、东方日…	东方日升新能源股份有限公司holdsData_logoWord	东方日升	东方日升新能源股份有限公司集团总部参观调研, 并就十四五期间在光伏
泉峰汽车:近期收到比亚迪股份有限公司全资子公司弗迪动力有限公司...	比亚迪股份有限公司holdsData_logoWord	比亚迪	比亚迪股份有限公司全资子公司弗迪动力有限公司. . . 😎
UFO党支部 | 走进郑州宇通客车股份有限公司党委	郑州宇通客车股份有限公司logoWord	宇通客车	宇通客车股份有限公司党委😎
根据业务发展和生产经营需要,深圳市兆新能源股份有限公司(以下简称“公司”)2021年度拟与深圳市虹彩新材料科技有限公司(以下简称“虹彩新材料”)发生日常关联交易,预计总金额不超过813.90万元,去年就采购原材料与虹彩新材料发生交易的金额...	深圳市兆新能源股份有限公司logoWord	兆新能源	兆新能源股份有限公司(以下简称公司) 2021年度拟与深圳市虹彩新材
近日，中移物联网有限公司与中兴通讯股份有限公司（以下简称“中兴通讯”）在重庆签署战略合作协议，中移物联网有限公司总经理乔辉、中兴通讯股份有限公司高级副总裁张万春共同见证签约。根据协议，双方将围绕“5G技术及行业深度合作”，在5G...	中兴通讯股份有限公司holdsData_logoWord	中兴通讯	中兴通讯股份有限公司（以下简称中兴通讯）在重庆签署战略合作协
国网河南省电力公司董事长、党委书记王金行到南阳供电公司调研	国网河南省电力公司directorsData_title	董事	董事长, 党委书记王金行到南阳供电公司调研😎
8月28日,江苏中信博新能源科技股份有限公司在科创板上市,成为江苏省昆山市首家在科创板上市的光伏智能支架系统企业。该公司股票代码688408。昆山今年上市(过会)企业7家,其中中信博、泽璟制药、佰奥智能、龙腾光电、沪光股份5家上市,伟时电...	江苏中信博新能源科技股份有限公司logoWord	中信博	中信博新能源科技股份有限公司在科创板上市, 成为江苏省昆山市首家在
根据国家政策方针,国有企业改革刻不容缓,而东风汽车集团有限公司作为一家资质较深国有企业,也应该迎合国企改革的潮流,在企业内部进行了大刀阔斧的改革。事实上,东风汽车集团有限公司一直走在改革发展的前沿,改...	东风汽车集团有限公司investRecordData_logoWord	汽车	汽车集团有限公司一直走在改革发展的前沿, 改. . . 😎😎
本公司董事会及全体董事保证本公告内容不存在任何虚假记载、误导性陈述或者重大遗漏,并对其内容的真实性、准确性和完整性承担个别及连带责任。 江苏振江新能源装备股份有限公司(以下简称“公司”)于近日收到了公司控股股东、实际控制人胡震、...	江苏振江新能源装备股份有限公司directorsData_name	胡震	胡震, . . . 😎
长城汽车股份有限公司(简称"长城汽车",股票代码:A股601633、H股02333)是在国内A股和香港H股均上市的知名汽车公司,拥有长城、哈弗、WEY和欧拉四个品牌,下属控股子公司40余家,员工7万余人。2017年,长城汽车资产总计达1105.47亿元。不仅拥有...	长城汽车股份有限公司logoWord	长城汽车	长城汽车股份有限公司(简称" 长城汽车" , 股票代码: a股601633, h
潍柴动力(潍坊)铸锻有限公司为潍柴动力股份有限公司全资子公司,目前拥有两个厂区——工业园区和安丘厂区,共8条全自动造型生产线。铸造规划建设项目于2005年3月立项,按照产业园区一期、产业园区二期、产业园区三期与安丘厂区,同步开展的总体规...	潍柴动力股份有限公司investRecordData_logoWord	潍柴动力	潍柴动力(潍坊) 铸锻有限公司为潍柴动力股份有限公司全资子公司, 目
珠海格力电器股份有限公司监事会主席辞职 将尽快补选	珠海格力电器股份有限公司directorsData_title	监事会主席	监事会主席辞职, 将尽快补选😎😎
沈浩，陕西延长石油(集团)有限责任公司(以下简称“延长石油集团”)原党委书记、董事长。贺久长，延长石油集团原党委副书记、董事长，曾任陕西省发改委副主任、省能源局局长。郝晓晨，陕西燃气集团有限公司原党委书记、董事长，公司为延长...	陕西延长石油(集团)有限责任公司directorsData_title	董事长	董事长。贺久长, 延长石油集团原党委副书记, 董事长, 曾任陕西省发改
(证监许可〔2021〕104号)核准,同意山西省国新能源股份有限公司(以下简称“国新能源”、“发行人”或“公司”)向华新燃气集团有限公司(以下简称“华新燃气集团”)发行不超过293,330,434股每股面值1.00元的人民币普通股(A股)(以下简称...	山西省国新能源股份有限公司logoWord	国新能源	国新能源股份有限公司(以下简称国新能源😎
云南电网有限责任公司临沧临翔供电局综合服务中心主任,原临沧玉带...	云南电网有限责任公司investRecordData_logoWord	供电	供电局综合服务中心主任, 原临沧玉带. . . 😎
大族激光科技产业集团股份有限公司(以下简称“公司”或“大族激光”)第六届董事会第四十五次会议通知于2021年4月2日以专人书面、电子邮件和传真的方式发出,会议于2021年4月7日以通讯形式召开,会议由董事长高云峰主持。会议应出席董事7...	大族激光科技产业集团股份有限公司logoWord	大族激光	大族激光科技产业集团股份有限公司(以下简称公司或大族激光
1、《关于转让牡丹江北冰洋电器公司股权的决议》; 2、 《关于挂牌转让子公司牡丹江北冰洋电器有限公司60%股权的公告》(2011-46)。 特此公告。 康佳集团股份有限公司 董事局 二○一二年八月十八日 ...	康佳集团股份有限公司logoWord	康佳	康佳集团股份有限公司, 董事局, 二○一二年八月十八日, . . . 😎
而解决方案是长城汽车将免费对召回范围内的车辆进行检查通气阀是否渗漏,如果渗漏将予以更换,从而消除缺陷。此外,长城汽车股份有限公司将通过挂号信和电话以及短信等方式通知有关用户的此次召回事宜。	长城汽车股份有限公司investRecordData_logoWord	长城汽车	长城汽车股份有限公司将通过挂号信和电话以及短信等方式通知有关用户
奋力追目标 争当先行军——东风汽车有限公司 ---在疫情防控、复工复产、追赶目标中争当先锋,东风有限上下始终牢记东风有限作为“东风先行军”的使命担当,鼓足干劲,马不停蹄,只争朝夕,把耽误的时间赶回来,把遭受的损失抢回来,为高质量...	东风汽车有限公司shareholdersData_logoWord	汽车	汽车有限公司, ---在疫情防控, 复工复产, 追赶目标中争当先锋, 东
今年七月份,晋商银行在港股上市,填补了山西省没有上市银行的空白。据财新网报道:晋商银行在港股IPO中共引入三名基石投资人,认购合共1.22亿美元股份,约占此次公开发售股份的30%。其中山西沁新能源集团股份有限公司认购5000万美元股份,太原...	山西沁新能源集团股份有限公司investRecordData_logoWord	沁新	沁新能源集团股份有限公司认购5000万美元股份, 太原. . .
商标转让完成后,“创维汽车”成为开沃新能源汽车集团旗下的智能汽车品牌。 开沃新能源汽车集团股份有限公司董事长黄宏生先生表示:“新能源汽车是保护环境、造福人类的产业。开沃新能源汽车集团‘十年磨一剑,一朝露锋芒’,如今将融合自身积累...	开沃新能源汽车集团股份有限公司directorsData_name	黄宏生	黄宏生先生表示: 新能源汽车是保护环境, 造福人类的产业。开沃新能
东风汽车有限公司3月8日召开了干部大会，大会上东风汽车集团有限公司党委宣布了新一轮人事调整，周先鹏不再担任东风汽车有限公司执行副总裁职务；陈昊任东风汽车有限公司执行副总裁；郭涛任东风汽车有限公司副总裁。会上，周先鹏表示，这次领导...	东风汽车有限公司logoWord	汽车	汽车集团有限公司党委宣布了新一轮人事调整, 周先鹏不再担任东风汽车
【财华社讯】潍柴动力公布,经中国证券监督管理委员会核发的《关于核准潍柴动力股份有限公司非公开发行股票的批复》(证监许可[2021]1407号),潍柴动力股份非公开发行不超过793,387,389股新股。本次发行实际发行数量为792,682,926股,每股...	潍柴动力股份有限公司holdsData_logoWord	潍柴动力	潍柴动力股份有限公司非公开发行股票的批复》(证监许可[2021] 1407号
云轨“再造”比亚迪 访比亚迪股份有限公司董事长兼总裁王传福	比亚迪股份有限公司directorsData_name	王传福	王传福😎😎
本公司及董事会全体成员保证信息披露的内容真实、准确、完整,没有虚假记载、误导性陈述或重大遗漏。 潍柴动力股份有限公司(下称“公司”)于2021年3月30日上午9:30,在山东省潍坊市高新技术产业开发区福寿东街197号甲公司会议室召开了五...	潍柴动力股份有限公司holdsData_logoWord	潍柴动力	潍柴动力股份有限公司(下称公司) 于2021年3月30日上午9: 30, 在
毛伟明董事长赴国网河南电力调研 高擎精神火炬奋力向前践行公司战略奋勇争先 7月14日，国家电网有限公司董事长、党组书记毛伟明一行赴国网河南省电力公司调研，了解基层情况，慰问干部职工。毛伟明强调，要深入学习贯彻习近平总书记重要讲话和...	国网河南省电力公司investRecordData_logoWord	国网河	国网河南省电力公司调研, 了解基层情况, 慰问干部职工。毛伟明强调,
珠海格力电器股份有限公司董事长兼总裁董明珠来钦考察	珠海格力电器股份有限公司directorsData_name	董明珠	董明珠来钦考察😎
座谈会上,刘彦鸿简要介绍了海州区的区情概况、区位优势、发展思路、营商环境、智能无人系统产业基地建设情况以及今后总体发展规划,华能新能源股份有限公司辽宁分公司总经理黄海燕介绍了公司概况、生产经营情况和风电、太阳能等新能源项目开发...	华能新能源股份有限公司shareholdersData_logoWord	华能	华能新能源股份有限公司辽宁分公司总经理黄海燕介绍了公司概况, 生产
浙江三花智能控制股份有限公司(以下简称“公司”)的全资子公司浙江三花汽车零部件有限公司(以下简称“三花汽零”)于近期收到比亚迪股份有限公司的全资子公司弗迪科技有限公司(以下简称“弗迪科技”)的通知,三花汽零被确定为弗迪科技新能源...	比亚迪股份有限公司holdsData_logoWord	弗迪科技	比亚迪股份有限公司的全资子公司弗迪科技有限公司(以下简称弗迪科
2019年6月10日下午,国家市场监督管理总局注意到珠海格力电器股份有限公司《关于奥克斯空调股份有限公司生产销售不合格空调产品的举报信》。我局对此高度关注,已于当日下午通知浙江省市场监督管理局对有关情况尽快进行调查核实,将依据调查核实的...	珠海格力电器股份有限公司logoWord	格力电器	格力电器股份有限公司《关于奥克斯空调股份有限公司生产销售不合格空
多氟多新能源科技有限公司董事长李云峰在接受记者采访。气质内敛，敦厚温和。这是多氟多新能源科技有限公司董事长李云峰给记者的直接印象。李云峰在接受记者采访时说：“坚定我们新能源的信仰，突破发展常规，以终为始，必将打造出行业内完美的...	多氟多新能源科技有限公司legalPerson	李云峰	李云峰在接受记者采访时说：坚定我们新能源的信仰, 突破发展常规,
关于出售资产的公告》（2020-33），拟转让参股公司荣盛盟固利新能源科技有限公司22.61%股权，涉及的交易对象为荣盛控股股份有限公司，转让价格以荣盛盟固利截至2020年3月31日股东全部权益评估值29.31亿元为基础，以荣盛盟固利全部股东...	荣盛盟固利新能源科技有限公司shareholdersData_subRate	1%	22.61% 股权, 涉及的交易对象为荣盛控股股份有限公司, 转让价格以荣
山东宝雅新能源汽车股份有限公司于去年底完成对一汽吉林汽车有限公司增资扩股后,依托一汽吉林整车资质和品牌优势,在烟台投建新能源汽车生产基地,同步设立研发中心、销售及进出口等机构。项目总投资100亿元,分两期建成,其中一期总投资40亿元。	山东宝雅新能源汽车股份有限公司investRecordData_logoWord	一汽吉林	一汽吉林汽车有限公司增资扩股后, 依托一汽吉林整车资质和品牌优势,
6月19日,云南电网公司召开干部大会,宣布南方电网公司党组对云南电网公司干部调整的决定。 (来源:微信公众号 云南电网 ID:csgyndw) 干部调整如下: ●甘霖同志任云南电网有限责任公司党委书记、董事长; ...	云南电网有限责任公司directorsData_title	董事长	董事长; , . . . 😎
河南易成新能源股份有限公司 独立董事候选人声明 声明人 张亚兵 作为河南易成新能源股份有限公司第五届董事会独立 董事候选人,现公开声明和保证,本人与该公司之间不存在任何影响本人独立性 的关系,且符合相关法律、行政法规、部门规章、...	河南易成新能源股份有限公司directorsData_title	董事	董事会独立, 董事候选人, 现公开声明和保证, 本人与该公司之间不存在
12月15日上午，特变电工新疆新能源股份有限公司山东分公司总经理王兴华带队到河口区河口街道考察光伏发电产业。河口区委常委、统战部长巴雷、区投促中心及街道相关负责人等陪同活动。考察组一行实地察看了曦和新能源100MW渔光互补光伏项目...	特变电工新疆新能源股份有限公司logoWord	特变电工	特变电工新疆新能源股份有限公司山东分公司总经理王兴华带队到河口区
智通财经APP讯，坚瑞沃能(300116.SZ)发布公告，该公司第四届董事会第四十六次会议和2020年第二次临时股东大会审议通过了《关于拟变更公司名称、证券简称及注册资本的议案》，同意公司将中文名称变更为“保力新能源科技股份有限公司”，...	保力新能源科技股份有限公司holdsData_logoWord	保力新	保力新能源科技股份有限公司, . . .
深圳古瑞瓦特新能源股份有限公司  企业认证: 已认证 所在地区: 广东 主营产品: 光伏逆变器、离网&储能产品、监控系统、光伏系统配件等 收藏此企业 联系方式 姓名: 古瑞瓦特 QQ: 暂无QQ 电话: 400-833-9981 手机: 暂无 邮箱: Chi...	深圳古瑞瓦特新能源股份有限公司logoWord	古瑞瓦特	古瑞瓦特新能源股份有限公司, , 企业认证: , 已认证, 所在地区: , 广
详见公司于2021年3月31日披露的《山西省国新能源股份有限公司关于公司向控股股东出售资产并签订股权转让协议暨关联交易的公告》(2021-024)。 表决结果:同意8票,反对0票,弃权0票。 关联董事刘军先生、凌人枫先生、陈勇明先生回避表决。	山西省国新能源股份有限公司directorsData_name	陈勇明	凌人枫先生, 陈勇明先生回避表决。
(北京)有限公司退出,变更为独立的法人股东:长城汽车股份有限公司,企业类型由其他有限责任公司变更为有限责任公司(外商投资企业法人独资),法定代表人由周小峰变更为沈增至,注册资本由1600万变更为5000万,董事(理事)、经理、监事由陈倩颖、...	长城汽车股份有限公司directorsData_title	董事	董事(理事) , 经理, 监事由陈倩颖, . . . 😎😎
